"<span class=""tags"">Linux</span><br /><br /><br>todo.txt:&nbsp;A <span class=cloze>[...]</span> in your todo.txt file represents a single task."	"<span class=""tags"">Linux</span><br /><br /><br>todo.txt:&nbsp;A <span class=cloze>single line</span> in your todo.txt file represents a single task.<br><br><br><div class=""extra""></div>"
"<span class=""tags"">Linux</span><br /><br /><br>Linux: ps stands for <span class=cloze>[...]</span>."	"<span class=""tags"">Linux</span><br /><br /><br>Linux: ps stands for <span class=cloze>process status</span>.<br><br><br><div class=""extra""></div>"
todo.txt: Notation for project	todo.txt: Notation for project<br><br><br /><br/><br>+project
todo.txt: Notation for context	todo.txt: Notation for context<br><br><br /><br/><br>@context
todo.txt: Command for deprioritizing tasks	todo.txt: Command for deprioritizing tasks<br><br><br /><br/><br>dp ITEM#[, ITEM#, ITEM#...]
todo.txt: How do you mark an item as done?	todo.txt: How do you mark an item as done?<br><br><br /><br/><br>do ITEM#[, ITEM#, ITEM#, ...]
todo.txt: How do you remove an item or a part of an item?	todo.txt: How do you remove an item or a part of an item?<br><br><br /><br/><br>rm ITEM# [TERM]
todo.txt: How do you list all the lines in todo.txt and done.txt that contain a specific term?	todo.txt: How do you list all the lines in todo.txt and done.txt that contain a specific term?<br><br><br /><br/><br>lsa [TERM...]
todo.txt: How do you list all of the projects in todo.txt?	todo.txt: How do you list all of the projects in todo.txt?<br><br><br /><br/><br>lsprj
todo.txt: How do you add priority to a task?	todo.txt: How do you add priority to a task?<br><br><br /><br/><br>p ITEM# PRIORITY
todo.txt: What value must PRIORITY be?	todo.txt: What value must PRIORITY be?<br><br><br /><br/><br>A letter between A and Z.
todo.txt: How do you replace a task with an updated todo?	"todo.txt: How do you replace a task with an updated todo?<br><br><br /><br/><br>replace ITEM# ""UPDATED TODO"""
What does grep stand for?	What does grep stand for?<br><br><br /><br/><br><b>G</b>lobally search a <b>r</b>egular <b>e</b>xpression and <b>p</b>rint.
What does the <code>grep</code> command do?	What does the <code>grep</code> command do?<br><br><br /><br/><br>It searches for a string in a file or stream.
What is dpkg?	What is dpkg?<br><br><br /><br/><br>A package manager for <i>Debian</i> based systems.
What command tells you the directory you're currently in?	What command tells you the directory you're currently in?<br><br><br /><br/><br>pwd
What does pwd stand for?	What does pwd stand for?<br><br><br /><br/><br><b>P</b>rint <b>w</b>orking <b>d</b>irectory.
What does the cd command stand for and do?	What does the cd command stand for and do?<br><br><br /><br/><br><b>C</b>hange <b>d</b>irectory
In bash, how do you go up one directory?	In bash, how do you go up one directory?<br><br><br /><br/><br>cd ..
What command lists files in a directory?	What command lists files in a directory?<br><br><br /><br/><br>ls
What is the root directory denoted by?	What is the root directory denoted by?<br><br><br /><br/><br>/
What is an absolute path?	What is an absolute path?<br><br><br /><br/><br>A path that begins in the root directory.<div><br /></div><div>Example: /etc/usr/share/X11</div>
What is a relative path?	What is a relative path?<br><br><br /><br/><br>A path that begins in the current directory.
How do you clear the screen in bash?	How do you clear the screen in bash?<br><br><br /><br/><br>clear
What is the bash shortcut for home?	What is the bash shortcut for home?<br><br><br /><br/><br>~
What button autocompletes a command?	What button autocompletes a command?<br><br><br /><br/><br>Tab
Using ls -l, what does the first column say?	Using ls -l, what does the first column say?<br><br><br /><br/><br>Whether it's a file or directory.
Using ls -l, what is the display order for file permissions?	Using ls -l, what is the display order for file permissions?<br><br><br /><br/><br>Owner, Group, Others
Using ls -l, what is the column before the filename?	Using ls -l, what is the column before the filename?<br><br><br /><br/><br>Date Modified
In Linux, hidden files are prepended by what symbol?	In Linux, hidden files are prepended by what symbol?<br><br><br /><br/><br>.
In bash, how do you pipe output from one command to another?	In bash, how do you pipe output from one command to another?<br><br><br /><br/><br>Using the pipe symbol (&nbsp;<code>|</code> )
Which pages are generally more in depth: man or info?	Which pages are generally more in depth: man or info?<br><br><br /><br/><br>info
What command option will produce a short usage description of the command and its options?	What command option will produce a short usage description of the command and its options?<br><br><br /><br/><br>-h or --help
In bash, how do you search for commands you've already typed?	"In bash, how do you search for commands you've already typed?<br><br><br /><br/><br>Using <span class=""code"">up/down</span>, or <span class=""code"">ctrl+r</span> and typing in part of the command."
In bash, what command lists all the commands that you've typed?	In bash, what command lists all the commands that you've typed?<br><br><br /><br/><br>history
What command executes a previously typed command from history?	What command executes a previously typed command from history?<br><br><br /><br/><br><code>!x</code><div>( x being the command number. )</div>
What does incremental history searching allow you to do?	What does incremental history searching allow you to do?<br><br><br /><br/><br>Type part of a previous command and find it.
"<span class=""tags"">Linux</span><br /><br /><br>A shell is software that provides an interface for users to access the services of a <span class=cloze>[...]</span>."	"<span class=""tags"">Linux</span><br /><br /><br>A shell is software that provides an interface for users to access the services of a <span class=cloze>kernel</span>.<br><br><br><div class=""extra""></div>"
"<span class=""tags"">Linux</span><br /><br /><br>BASH is an acronym for <span class=cloze>[...]</span>."	"<span class=""tags"">Linux</span><br /><br /><br>BASH is an acronym for <span class=cloze>Bourne Again Shell</span>.<br><br><br><div class=""extra""></div>"
"<span class=""tags"">Linux</span><br /><br /><br>A script is basically a <span class=cloze>[...]</span>, but stored in a file."	"<span class=""tags"">Linux</span><br /><br /><br>A script is basically a <span class=cloze>list of commands</span>, but stored in a file.<br><br><br><div class=""extra""></div>"
What command is useful for when you know what you want to do, but don't know the name of the tool required?	"What command is useful for when you know what you want to do, but don't know the name of the tool required?<br><br><br /><br/><br><span style=""font-size: 20px"">apropos</span>"
What is the command for making a directory?	What is the command for making a directory?<br><br><br /><br/><br>mkdir
What command creates an empty file in bash?	What command creates an empty file in bash?<br><br><br /><br/><br>touch FILE
What command removes an empty directory in bash?	What command removes an empty directory in bash?<br><br><br /><br/><br>rmdir&nbsp;
What command would remove everything on your system and should never be used?	What command would remove everything on your system and should never be used?<br><br><br /><br/><br>rm -rf /
What command removes files?	What command removes files?<br><br><br /><br/><br>rm
What command removes directories and all of their contents?	What command removes directories and all of their contents?<br><br><br /><br/><br>rm -r
What command moves or renames a file?	What command moves or renames a file?<br><br><br /><br/><br>mv SOURCE DEST
What command copies a file?	What command copies a file?<br><br><br /><br/><br>cp SOURCE DEST
What command prints the output of a file or files?	What command prints the output of a file or files?<br><br><br /><br/><br>cat
"What is <span style=""color: navy;font-family:'source code pro'"">cat</span> an abbreviation of?"	"What is <span style=""color: navy;font-family:'source code pro'"">cat</span> an abbreviation of?<br><br><br /><br/><br>catenate"
In bash how do you update the filesystem database for searching?	In bash how do you update the filesystem database for searching?<br><br><br /><br/><br>sudo updatedb
What is the command to locate a file?	What is the command to locate a file?<br><br><br /><br/><br>locate
Does Linux require file extensions?	Does Linux require file extensions?<br><br><br /><br/><br>No
<br>A file name extension is a <span class=cloze>[...]</span> to the filename separated by a dot which indicates its&nbsp;content or usage.	"<br>A file name extension is a <span class=cloze>suffix</span> to the filename separated by a dot which indicates its&nbsp;content or usage.<br><br><br><div class=""extra""></div>"
<br>A file name extension is a suffix to the filename separated by a dot which indicates its&nbsp;<span class=cloze>[...]</span>.	"<br>A file name extension is a suffix to the filename separated by a dot which indicates its&nbsp;<span class=cloze>content or usage</span>.<br><br><br><div class=""extra""></div>"
When might a file extension be required in Linux?	When might a file extension be required in Linux?<br><br><br /><br/><br>Some programs use them.
What does chmod stand for?	What does chmod stand for?<br><br><br /><br/><br>Change mode
What does apt stand for?	What does apt stand for?<br><br><br /><br/><br>Advanced Packaging Tool
"<span class=""tags"">Linux</span><br /><br /><br>fglrx stands for <span class=cloze>[...]</span>."	"<span class=""tags"">Linux</span><br /><br /><br>fglrx stands for <span class=cloze>FireGL and Radeon for X</span>.<br><br><br><div class=""extra""></div>"
"<span class=""tags"">Linux</span><br /><br /><br>The X Window System originated at <span class=cloze>[...]</span> in 1984."	"<span class=""tags"">Linux</span><br /><br /><br>The X Window System originated at <span class=cloze>MIT</span> in 1984.<br><br><br><div class=""extra""></div>"
"<span class=""tags"">Linux</span><br /><br /><br>The X Window System originated at MIT in <span class=cloze>[...]</span>."	"<span class=""tags"">Linux</span><br /><br /><br>The X Window System originated at MIT in <span class=cloze>1984</span>.<br><br><br><div class=""extra""></div>"
"<span class=""tags"">Linux</span><br /><br /><br>The <span class=cloze>[...]</span> leads the X project."	"<span class=""tags"">Linux</span><br /><br /><br>The <span class=cloze>X.Org Foundation</span> leads the X project.<br><br><br><div class=""extra""></div>"
CSS properties generally fall into what two categories?	CSS properties generally fall into what two categories?<br><br><br /><br/><br>Presentation and Layout
What does DNS stand for?	What does DNS stand for?<br><br><br /><br/><br>Domain Name System
"<span class=""tags"">HTML</span><br /><br /><br>Domain name systems tell your computer the IP address associated with a <span class=cloze>[...]</span>."	"<span class=""tags"">HTML</span><br /><br /><br>Domain name systems tell your computer the IP address associated with a <span class=cloze>domain name</span>.<br><br><br><div class=""extra""></div>"
"<span class=""tags"">HTML</span><br /><br /><br>Domain name systems tell your computer the <span class=cloze>[...]</span> associated with a domain name."	"<span class=""tags"">HTML</span><br /><br /><br>Domain name systems tell your computer the <span class=cloze>IP address</span> associated with a domain name.<br><br><br><div class=""extra""></div>"
"<span class=""tags"">HTML</span><br /><br /><br>Adding descriptive tags to a text document is known as <span class=cloze>[...]</span> the document."	"<span class=""tags"">HTML</span><br /><br /><br>Adding descriptive tags to a text document is known as <span class=cloze>marking up</span> the document.<br><br><br><div class=""extra""></div>"
What is hypertext?	What is hypertext?<br><br><br /><br/><br>Text with hyperlinks
What does HTML stand for?	What does HTML stand for?<br><br><br /><br/><br>Hypertext Markup Language
"<span class=""tags"">HTML</span><br /><br /><br>HTML documents are made up of <span class=cloze>[...]</span>."	"<span class=""tags"">HTML</span><br /><br /><br>HTML documents are made up of <span class=cloze>elements</span>.<br><br><br><div class=""extra""></div>"
"<div class=""tags"">HTML</div><br>What does <u>&lt;html&gt;</u>&nbsp;represent?"	The root of an HTML document
"<div class=""tags"">HTML</div><br>What does the&nbsp;<u>&lt;body&gt;</u>&nbsp;element do?"	Its contents are shown in the browser window
"<div class=""tags"">HTML</div><br>What does&nbsp;<u>&lt;h1&gt;</u>&nbsp;denote?"	Main heading
"<div class=""tags"">HTML</div><br>What is an&nbsp;<u>&lt;h2&gt;</u>?"	A sub-heading.
"<div class=""tags"">HTML</div><br>What is a&nbsp;<u>&lt;p&gt;</u>?"	Paragraph
"<span class=""tags"">HTML</span><br /><br /><br>Strictly speaking, an element comprises the opening and closing tags, and <span class=cloze>[...]</span>."	"<span class=""tags"">HTML</span><br /><br /><br>Strictly speaking, an element comprises the opening and closing tags, and <span class=cloze>anything between them</span>.<br><br><br><div class=""extra""><span class=""code"">&lt;!-- Some markup --&gt;<font color=""#55aa00"">&lt;p&gt;</font></span><font color=""#55aa00"">Example: everything between these tags, and the tags themselves, comprise a <span class=""code"">&lt;p&gt;</span> element.</font><span class=""code""><font color=""#55aa00"">&lt;/p&gt;</font>&lt;!-- More markup --&gt;</span></div>"
"<span class=""tags"">HTML</span><br /><br /><br>Strictly speaking, an element comprises the <span class=cloze>[...]</span>, and anything between them."	"<span class=""tags"">HTML</span><br /><br /><br>Strictly speaking, an element comprises the <span class=cloze>opening and closing tags</span>, and anything between them.<br><br><br><div class=""extra""><span class=""code"">&lt;!-- Some markup --&gt;<font color=""#55aa00"">&lt;p&gt;</font></span><font color=""#55aa00"">Example: everything between these tags, and the tags themselves, comprise a <span class=""code"">&lt;p&gt;</span> element.</font><span class=""code""><font color=""#55aa00"">&lt;/p&gt;</font>&lt;!-- More markup --&gt;</span></div>"
"<span class=""tags"">HTML</span><br /><br /><br>Attributes provide additional information about the content of <span class=cloze>[...]</span>."	"<span class=""tags"">HTML</span><br /><br /><br>Attributes provide additional information about the content of <span class=cloze>an element</span>.<br><br><br><div class=""extra""></div>"
"<span class=""tags"">HTML</span><br /><br /><br><span class=cloze>[...]</span> provide additional information about the content of an element."	"<span class=""tags"">HTML</span><br /><br /><br><span class=cloze>Attributes</span> provide additional information about the content of an element.<br><br><br><div class=""extra""></div>"
"<div class=""tags"">HTML</div><br>What is <u>src=""/images/oak.png""</u>&nbsp;an example of?"	An attribute
"<span class=""tags"">HTML</span><br /><br /><br>Attributes appear on the <span class=cloze>[...]</span> tag of an element."	"<span class=""tags"">HTML</span><br /><br /><br>Attributes appear on the <span class=cloze>opening</span> tag of an element.<br><br><br><div class=""extra""></div>"
"<div class=""tags"">HTML</div><br>What are the parts of an HTML attribute?"	A <u>name</u>&nbsp;and a <u>value</u>
"<div class=""tags"">HTML</div><br>What must the <u>value</u>&nbsp;of an attribute be placed in?"	Double quotes
"<div class=""tags"">HTML</div><br>What are the <u>name</u>&nbsp;and <u>value</u>&nbsp;of an attribute separated by?"	An equals sign
"<span class=""tags"">HTML</span><br /><br /><br>A markup language allows you to <span class=cloze>[...]</span>&nbsp;text."	"<span class=""tags"">HTML</span><br /><br /><br>A markup language allows you to <span class=cloze>annotate</span>&nbsp;text.<br><br><br><div class=""extra""></div>"
"<div class=""tags"">HTML</div><br>How many heading levels does HTML have?"	Six
"<div class=""tags"">HTML</div><br>What are&nbsp;<u>&lt;sup&gt;</u>&nbsp;and <u>&lt;sub&gt;</u>?"	<sup>Super</sup>script and <sub>sub</sub>script.
"<div class=""tags"">HTML</div><br>What do browsers do when there is more than one space between characters?"	White space collapsing
"<div class=""tags"">HTML</div><br>What does <u>&lt;pre&gt;</u>&nbsp;stand for?"	Preformatted text
"<span class=""tags"">HTML</span><br /><br /><br><span class=cloze>[...]</span>&nbsp;elements have only one tag."	"<span class=""tags"">HTML</span><br /><br /><br><span class=cloze>Empty</span>&nbsp;elements have only one tag.<br><br><br><div class=""extra""></div>"
"<div class=""tags"">HTML</div><br>What are elements with no content called?"	Empty elements
"<div class=""tags"">HTML</div><br>What does&nbsp;<u>&lt;strong&gt;</u>&nbsp;do semantically?"	It defines important text.
"<div class=""tags"">HTML</div><br>What is a&nbsp;<u>&lt;br&gt;</u>?"	Single line break
"<div class=""tags"">HTML</div><br>What does an&nbsp;<u>&lt;hr&gt;</u>&nbsp;represent&nbsp;<i>semantically</i>?"	A thematic change.
"<div class=""tags"">HTML</div><br>What does&nbsp;<u>&lt;em&gt;</u>&nbsp;denote?"	Emphasized text
"<div class=""tags"">HTML</div><br>Which element is used for block quotes?"	<u>&lt;blockquote&gt;</u>
"<div class=""tags"">HTML</div><br>What is a&nbsp;<u>&lt;q&gt;</u>?"	A short quotation.
"<div class=""tags"">HTML</div><br>What attribute do <u>&lt;blockquote&gt;</u>&nbsp;and <u>&lt;q&gt;</u>&nbsp;have in common?"	<u>cite</u><div><u><br /></u></div><div>It specifies the source of the quotation.</div>
"<div class=""tags"">HTML</div><br>What is an&nbsp;<u>&lt;abbr&gt;</u>?"	"An abbreviation or acronym.<div><br /></div><example><lang class=""html"">HTML</lang>&lt;abbr title=""Line Shape Value""&gt;LSV&lt;/abbr&gt; forms visual perception in drawing.</example><div><br /><div><abbr title=""Line Shape Value"">LSV</abbr> forms visual perception in drawing.</div></div>"
"<div class=""tags"">HTML</div><br>What attribute specifies the full term of <u>&lt;abbr&gt;</u>?"	<u>title</u>
"<div class=""tags"">HTML</div><br>What does <u>&lt;cite&gt;</u>&nbsp;do?"	Defines the title of a work.<div><br /></div><div>Example:&nbsp;&nbsp;<u>&lt;p&gt;&lt;cite&gt;</u>The Magic of Thinking BIG<u>&lt;/cite&gt;</u> by David J. Schwartz. Published in 1959.<u>&lt;/p&gt;</u>&nbsp;</div>
"<div class=""tags"">HTML</div><br>What does a&nbsp;<u>&lt;dfn&gt;</u>&nbsp;represent?"	"The defining instance of a term.<example><div><u>&lt;p&gt;</u>&nbsp;A&nbsp;<u><font color=""#b64545"">&lt;dfn&gt;</font>l</u>ine<u><font color=""#b64545"">&lt;/dfn&gt;</font></u>&nbsp;is a long, narrow mark.&nbsp;<u>&lt;/p&gt;</u></div></example><br><p> A <dfn>line</dfn> is a long, narrow mark. </p>"
"<div class=""tags"">HTML</div><br>What does&nbsp;<u>&lt;address&gt;</u>&nbsp;contain?"	Contact information of the author
"<div class=""tags"">HTML</div><br>What does&nbsp;<u>&lt;ol&gt;</u>&nbsp;stand for?"	Ordered list
"<div class=""tags"">HTML</div><br>What is a&nbsp;<u>&lt;ul&gt;</u>?"	An unordered list.
"<div class=""tags"">HTML</div><br>What is an&nbsp;<u>&lt;li&gt;</u>?"	A list item.
"<div class=""tags"">HTML</div><br>What does&nbsp;<u>&lt;dl&gt;</u>&nbsp;stand for?"	Description list
"<div class=""tags"">HTML</div><br>What is a&nbsp;<u>&lt;dt&gt;</u>?"	Term in a description list.
"<div class=""tags"">HTML</div><br>What is a&nbsp;<u>&lt;dd&gt;</u>?"	Description <i>of a term</i> in a description list
"<div class=""tags"">HTML</div><br>What are the three list types in HTML?"	Ordered, Unordered, and Description
"<span class=""tags"">HTML</span><br /><br /><br><div><span class=cloze>[...]</span> are the defining feature of the web.</div>"	"<span class=""tags"">HTML</span><br /><br /><br><div><span class=cloze>Links</span> are the defining feature of the web.</div><br><br><br><div class=""extra""></div>"
"<span class=""tags"">HTML</span><br /><br /><br>Hyperlinks are created using the <span class=cloze>[...]</span> element."	"<span class=""tags"">HTML</span><br /><br /><br>Hyperlinks are created using the <span class=cloze><span class=""code"">&lt;a&gt;</span></span> element.<br><br><br><div class=""extra""></div>"
"<div class=""tags"">HTML</div><br>What can users click on between <u>&lt;a&gt;</u>&nbsp;and <u>&lt;/a&gt;</u>?"	Anything
"<div class=""tags"">HTML</div><br>What does&nbsp;<u>href</u>&nbsp;stand for?"	Hypertext reference
"<div class=""tags"">HTML</div><br>What does the&nbsp;<u>href</u>&nbsp;attribute do?"	Specifies the URL of an <u>&lt;a&gt;</u> element
"<div class=""tags"">CSS</div><br>What does an absolute URL point to?"	Another web site
"<div class=""tags"">HTML</div><br>What does a relative URL point to?"	A file <i>within</i> a web site
"<div class=""tags"">CSS</div><br>What does an anchor URL point to?"	The <u>id</u> of an element
"<div class=""tags"">HTML</div><br>In HTML 5, which elements can <u>id</u>&nbsp;and <u>class</u>&nbsp;be used by?"	All of them
"<div class=""tags"">CSS</div><br>What symbol points to an <u>id</u>?"	"<u>#</u><example><div>HTML:&nbsp;<u>&lt;nav <font color=""#b64545"">id=""navbar""</font>&gt;</u>&nbsp;</div><div><u>CSS: <font color=""#b64545"">#navbar</font> { </u><u>text-align: center;&nbsp;</u><u>}</u></div></example>"
"<div class=""tags"">HTML</div><br>What type of element sits within a block element?"	Inline
"<span class=""tags"">HTML</span><br /><br /><br>The images you use should be saved at the <span class=cloze>[...]</span> you want them to appear on the page."	"<span class=""tags"">HTML</span><br /><br /><br>The images you use should be saved at the <span class=cloze>same size</span> you want them to appear on the page.<br><br><br><div class=""extra""></div>"
"<div class=""tags"">HTML</div><br>What does&nbsp;<u>&lt;figure&gt;</u>&nbsp;do?"	Contains an image and its caption.
"<div class=""tags"">HTML</div><br>What is a&nbsp;<u>&lt;figcaption&gt;</u>?"	A caption of an image
"<div class=""tags"">HTML</div><br>What does an&nbsp;<u>&lt;img&gt;</u>&nbsp;element contain?"	An image
"<span class=""tags"">HTML</span><br /><br /><br>Photographs are best saved as .<span class=cloze>[...]</span>s"	"<span class=""tags"">HTML</span><br /><br /><br>Photographs are best saved as .<span class=cloze>JPG</span>s<br><br><br><div class=""extra""></div>"
"<span class=""tags"">HTML</span><br /><br /><br>Images with hard transitions or high detail should be saved as .<span class=cloze>[...]</span>s"	"<span class=""tags"">HTML</span><br /><br /><br>Images with hard transitions or high detail should be saved as .<span class=cloze>PNG</span>s<br><br><br><div class=""extra""></div>"
"<span class=""tags"">HTML</span><br /><br /><br>Never save <span class=cloze>[...]</span> PNG files."	"<span class=""tags"">HTML</span><br /><br /><br>Never save <span class=cloze>interlaced</span> PNG files.<br><br><br><div class=""extra""></div>"
"<div class=""tags"">HTML</div><br>What declaration should each webpage begin with?"	<u>DOCTYPE</u>
"<div class=""tags"">HTML</div><br>What does a <u>!DOCTYPE </u>declaration tell the browser?"	Which version of HTML the page uses
"<div class=""tags"">HTML</div><br>What is&nbsp;<u>&lt;!-- &nbsp;--&gt;</u>?"	HTML Comment
"<div class=""tags"">HTML</div><br>What <i>type</i> of attribute can be used on any element?"	Global<div><br /></div><div>Examples: <u>class</u>, <u>id</u></div>
"<div class=""tags"">HTML</div><br>What attribute is used to uniquely identify an element?"	<u>id</u>
"<span class=""tags"">CSS</span><br /><br /><br><span class=cloze>[...]</span> is to element as declaration is to rule."	"<span class=""tags"">CSS</span><br /><br /><br><span class=cloze>Attribute</span> is to element as declaration is to rule.<br><br><br><div class=""extra"">&lt;img <font color=""#00aa7f"">src=""example.png""</font>&gt; p { <font color=""#00aa7f"">font-family: Georgia;</font>}</div>"
"<span class=""tags"">CSS</span><br /><br /><br>Attribute is to element as <span class=cloze>[...]</span> is to rule."	"<span class=""tags"">CSS</span><br /><br /><br>Attribute is to element as <span class=cloze>declaration</span> is to rule.<br><br><br><div class=""extra"">&lt;img <font color=""#00aa7f"">src=""example.png""</font>&gt; p { <font color=""#00aa7f"">font-family: Georgia;</font>}</div>"
"<span class=""tags"">CSS HTML</span><br /><br /><br><span class=cloze>[...]</span> is to attribute as <span class=cloze>[...]</span> is to declaration."	"<span class=""tags"">CSS HTML</span><br /><br /><br><span class=cloze>Name</span> is to attribute as <span class=cloze>property</span> is to declaration.<br><br><br><div class=""extra"">Attribute: [<font color=""#206c7d""><b> lang</b></font>=<b><font color=""#eba818"">""en-us"" </font></b>]<div>Declaration:&nbsp;[&nbsp;<font color=""#206c7d""><b>color:</b></font> <b><font color=""#eba818"">yellow; </font></b>]</div></div>"
"<span class=""tags"">CSS HTML</span><br /><br /><br>Name is to <span class=cloze>[...]</span> as property is to <span class=cloze>[...]</span>."	"<span class=""tags"">CSS HTML</span><br /><br /><br>Name is to <span class=cloze>attribute</span> as property is to <span class=cloze>declaration</span>.<br><br><br><div class=""extra"">Attribute: [<font color=""#206c7d""><b> lang</b></font>=<b><font color=""#eba818"">""en-us"" </font></b>]<div>Declaration:&nbsp;[&nbsp;<font color=""#206c7d""><b>color:</b></font> <b><font color=""#eba818"">yellow; </font></b>]</div></div>"
"<div class=""tags"">HTML</div><br>What character should an element&nbsp;<u>id</u>&nbsp;start with?"	A letter or an underscore.<div><br /></div><div>Additionally, <u>id</u>s are <i>referenced</i>&nbsp;in CSS using <u>#</u>.</div>
"<div class=""tags"">HTML</div><br>What attribute identifies several elements as part of a group?"	<u>class</u>
"<span class=""tags"">HTML</span><br /><br /><br>Class names are separated with a <span class=cloze>[...]</span>."	"<span class=""tags"">HTML</span><br /><br /><br>Class names are separated with a <span class=cloze>space</span>.<br><br><br><div class=""extra""></div>"
"<div class=""tags"">HTML</div><br>What is a&nbsp;<u>&lt;div&gt;</u>&nbsp;used as?"	A generic container.
"<div class=""tags"">HTML</div><br>What is the&nbsp;<u>&lt;span&gt;</u>&nbsp;element?"	An inline version of <u>&lt;div&gt;</u>
"<span class=""tags"">CSS</span><br /><br /><br>A rule contains two parts: a selector and a <span class=cloze>[...]</span>."	"<span class=""tags"">CSS</span><br /><br /><br>A rule contains two parts: a selector and a <span class=cloze>declaration</span>.<br><br><br><div class=""extra""></div>"
"<span class=""tags"">CSS</span><br /><br /><br>A rule contains two parts: a <span class=cloze>[...]</span> and a declaration."	"<span class=""tags"">CSS</span><br /><br /><br>A rule contains two parts: a <span class=cloze>selector</span> and a declaration.<br><br><br><div class=""extra""></div>"
"<span class=""tags"">CSS</span><br /><br /><br>The key to understanding how CSS works is to imagine that there is an <span class=cloze>[...]</span> around every HTML element."	"<span class=""tags"">CSS</span><br /><br /><br>The key to understanding how CSS works is to imagine that there is an <span class=cloze>invisible box</span> around every HTML element.<br><br><br><div class=""extra""></div>"
"<div class=""tags"">CSS</div><br>What does CSS stand for?"	Cascading Style Sheets
"<span class=""tags"">CSS</span><br /><br /><br><span class=cloze>[...]</span> is to HTML as <span class=cloze>[...]</span> is to CSS."	"<span class=""tags"">CSS</span><br /><br /><br><span class=cloze>Element</span> is to HTML as <span class=cloze>rule</span> is to CSS.<br><br><br><div class=""extra""></div>"
"<span class=""tags"">CSS</span><br /><br /><br>Element is to <span class=cloze>[...]</span> as rule is to <span class=cloze>[...]</span>."	"<span class=""tags"">CSS</span><br /><br /><br>Element is to <span class=cloze>HTML</span> as rule is to <span class=cloze>CSS</span>.<br><br><br><div class=""extra""></div>"
"<span class=""tags"">CSS</span><br /><br /><br>A CSS rule selects an element and <span class=cloze>[...]</span> how it should look."	"<span class=""tags"">CSS</span><br /><br /><br>A CSS rule selects an element and <span class=cloze>declares</span> how it should look.<br><br><br><div class=""extra""></div>"
"<span class=""tags"">CSS</span><br /><br /><br>A CSS rule <span class=cloze>[...]</span> an element and declares how it should look."	"<span class=""tags"">CSS</span><br /><br /><br>A CSS rule <span class=cloze>selects</span> an element and declares how it should look.<br><br><br><div class=""extra""></div>"
"<span class=""tags"">CSS</span><br /><br /><br>A CSS <span class=cloze>[...]</span> selects an element and declares how it should look."	"<span class=""tags"">CSS</span><br /><br /><br>A CSS <span class=cloze>rule</span> selects an element and declares how it should look.<br><br><br><div class=""extra""></div>"
What are the two parts of a CSS <b>rule</b>?	What are the two parts of a CSS <b>rule</b>?<br><br><br /><br/><br><b>Selector</b> and <b>Declaration</b>
What must each CSS declaration end with?	What must each CSS declaration end with?<br><br><br /><br/><br>A semicolon
"<div class=""tags"">CSS</div><br>What type of selector is <u><font color=""#b64545"">p</font> { color: navy; }</u>?"	Type
"<div class=""tags"">CSS</div><br>What type of selector is <u><font color=""#b64545"">li em</font> { color: olive; }</u>?"	Descendant
"<div class=""tags"">CSS</div><br>What type of selector is <u><font color=""#b64545"">p, ul, td, th</font> { color: maroon }</u>?"	Grouped
"<div class=""tags"">CSS</div><br>What type of selector is <u><font color=""#b64545"">p &gt; em</font> { font-weight: bold; }</u>?"	Child
"<div class=""tags"">CSS</div><br>What type of selector is <u><font color=""#b64545"">#catalog</font> { color: red; }</u>?"	Id
"<div class=""tags"">CSS</div><br>What type of selector is <u><font color=""#b64545"">.special</font> { color: orange; }</u>?"	Class
"<div class=""tags"">CSS</div><br>What is a group of declarations called?"	A declaration block
"<div class=""tags"">CSS</div><br>What are declaration blocks enclosed by?"	Braces <u>{ }</u>
"<div class=""tags"">CSS</div><br>What happens if a simple selector within a selector is invalid?"	The whole selector is invalid.
"<div class=""tags"">HTML</div><br>What four attributes <i>should</i>&nbsp;<u>&lt;link&gt;</u>&nbsp;have when including a stylesheet in a page?"	"<u>rel</u>, <u>type</u>,&nbsp;<u>href</u>,&nbsp;and <u>media</u><div><u><br /></u></div><div>Example:&nbsp;<u>&lt;link <b>rel</b>=""stylesheet"" <b>type</b>=""text/css"" <b>href</b>=""http://draw.academy/css.css"" <b>media</b>=""screen"" /&gt;</u></div>"
"<div class=""tags"">CSS</div><br>What type of selector is &nbsp;<u><font color=""#b64545"">*</font> {</u><u>&nbsp;border: 1px solid black;&nbsp;</u><u>}</u>?"	Universal
"<div class=""tags"">CSS</div><br>What type of selector is <u><font color=""#b64545"">h1 + p</font> { color: tomato }</u>?"	Adjacent sibling
"<div class=""tags"">CSS</div><br>If two rules have identical selectors, which takes precedence?"	The last one
"<span class=""tags"">CSS</span><br /><br /><br>The most <span class=cloze>[...]</span> selector takes precedence."	"<span class=""tags"">CSS</span><br /><br /><br>The most <span class=cloze>specific</span> selector takes precedence.<br><br><br><div class=""extra""></div>"
"<div class=""tags"">CSS</div><br>What can be added to the end any CSS declaration to give it the highest priority?"	<u>!important</u>
"<span class=""tags"">CSS</span><br /><br /><br>When inheritance occurs, elements inherit <span class=cloze>[...]</span> values."	"<span class=""tags"">CSS</span><br /><br /><br>When inheritance occurs, elements inherit <span class=cloze>computed</span> values.<br><br><br><div class=""extra""></div>"
"<div class=""tags"">CSS</div><br>What determines whether a property is inherited or not?"	The property definition
"<div class=""tags"">CSS</div><br>What does CSS use to permit formatting information that lies outside of the document tree?"	Pseudo-elements and pseudo-classes
"<div class=""tags"">CSS</div><br>What is the tree of elements encoded in an HTML document called?"	Document tree
"<div class=""tags"">CSS</div><br>Where are pseudo-elements allowed to be used?"	Only at the end of a selector.<div><br /></div><div>Example: <u>#menu li &gt; div::before</u></div>
"<div class=""tags"">CSS</div><br>Where are pseudo-classes allowed to be used in selectors?"	Anywhere
"<div class=""tags"">CSS</div><br><u>/* &nbsp; &nbsp; */</u>"	CSS Comment
"<div class=""tags"">CSS</div><br>What property determines if text is bold?"	<u>font-weight</u>
"<div class=""tags"">CSS</div><br>What property determines if text is italic?"	<u>font-style</u>
"<div class=""tags"">CSS</div><br>What property changes the case of text?"	<u>text-transform</u>
"<div class=""tags"">CSS</div><br><u>underline</u>&nbsp;and <u>none</u>&nbsp;are values of what property?"	<u>text-decoration</u>
"<div class=""tags"">CSS</div><br>What property controls the alignment of text?"	<u>text-align</u>
"<div class=""tags"">HTML</div><br>What type of element is used only to add meaning?"	Semantic
"<div class=""tags"">CSS</div><br>What four properties specify the offset amount from their respective edge?"	<u>top</u>, <u>right</u>, <u>bottom</u>, and <u>left</u>
"<div class=""tags"">CSS</div><br>What four values does <u>text-shadow</u>&nbsp;take?"	<u>x-offset</u>, <u>y-offset</u>, <u>blur-radius</u>, and <u>color</u>
"<div class=""tags"">CSS</div><br>What order should link pseudo-classes be specified in?"	<u>:link</u>, <u>:visited</u>, <u>:hover</u>, <u>:active</u>
"<div class=""tags"">CSS</div><br>What is the default height of a block element?"	Just enough to hold its contents
"<div class=""tags"">CSS</div><br>What two properties specify box dimensions?"	<u>width</u>&nbsp;and <u>height</u>
"<div class=""tags"">CSS</div><br>What property tells the browser what to do if the content of a box is larger than the box itself?"	<u>overflow</u>
"<div class=""tags"">CSS</div><br><div><img src=""Box model.png"" /></div><div><br /></div><div>What is the gray area called?</div>"	Content area
"<div class=""tags"">CSS</div><br><img src=""Box model.png"" /><div><br /></div><div>What is the yellow area called?</div>"	Padding
"<div class=""tags"">CSS</div><br><img src=""Box model.png"" /><div><br /></div><div>What is the black area called?</div>"	Border
"<div class=""tags"">CSS</div><br><img src=""Box model.png"" /><div><br /></div><div>What is the blue area called?</div>"	Margin
"<div class=""tags"">CSS</div><br>What do a <u>border</u>, <u>margin</u>, and <u>padding</u>&nbsp;do to box dimensions?"	Increase it
"<div class=""tags"">CSS</div><br>What are the three values of the <u>border</u>&nbsp;shorthand?"	<u>width</u>, <u>style</u>, and <u>color</u>
"<div class=""tags"">CSS</div><br>What is the directional order for&nbsp;<u>border</u>, <u>margin</u>, and <u>padding</u>&nbsp;properties?"	<u>top</u>, <u>right</u>, <u>bottom</u>, <u>left</u>
"<div class=""tags"">CSS</div><br>What is the two-value directional shorthand?"	top/bottom, left/right
"<div class=""tags"">CSS</div><br>What property specifies the type of rendering box used for an element?"	<u>display</u>
"<div class=""tags"">CSS</div><br>What property can hide boxes but leave the original space intact?"	<u>visibility</u>
"<div class=""tags"">CSS</div><br>What property creates rounded corners?"	<u>border-radius</u>
"<div class=""tags"">CSS</div><br>What values does <u>list-style</u>&nbsp;shorthand use?"	"<u>-image</u>, <u>-position</u>, and <u>-type</u><div><u><br /></u></div><example><lang class=""html"">HTML</lang><div><u>&lt;ul&gt;</u></div><div><u>&nbsp;&lt;li&gt;This omits the type property.&lt;/li&gt;</u></div><div><u>&nbsp;&lt;li class=""type""&gt;This omits the image property.&lt;/li&gt;</u></div><div><u>&lt;/ul&gt;</u></div></example><br><example><lang class=""css"">CSS</lang><div><u>li { list-style: url(""disc_icon.png"") inside }</u></div><div><u>.type { list-style: inside square }</u></div></example><br /><br><ul><br><li style=""margin-bottom: 1em; list-style: inside none; height: 26px; line-height: 26px""><br><img src=""disc_icon.png"" /><br><p style=""vertical-align: middle; display: inline-block"">This omits the type property.</p><br></li><br><li style=""list-style: inside square"">This omits the image property.</li><br></ul>"
"<div class=""tags"">CSS</div><br>Which elements generate a rectangular box?"	All of them.
"<div class=""tags"">CSS</div><br>What marks the total area of a box?"	The margin edge
"<div class=""tags"">CSS</div><br>According to the CSS specification, what happens if no border style is specified?"	The border doesn't exist.
"<div class=""tags"">CSS</div><br>What is percentage value based on in CSS?"	The <u>width</u>&nbsp;of the parent
"<div class=""tags"">CSS</div><br>What do the top and bottom margins of neighboring elements do?"	Collapse
"<div class=""tags"">CSS</div><br>When margins collapse, which value is used?"	The largest
"<div class=""tags"">CSS</div><br>For what two types of elements do margins not collapse?"	Floated and absolute
"<div class=""tags"">CSS</div><br>When do side margins collapse?"	Never
"<div class=""tags"">CSS</div><br>Is content that has <u>display:none</u>&nbsp;still downloaded?"	Yes
"<div class=""tags"">CSS</div><br>In the CSS layout model, elements are laid out from top to bottom in what order?"	The order they appear in the source.
"<div class=""tags"">CSS</div><br>What is the default width of a block element?"	The width of its container
"<div class=""tags"">HTML</div><br>What is the default behavior of inline elements?"	They line up to fill block elements
"<div class=""tags"">CSS</div><br>What property allows the following content to wrap around it?"	<u>float</u>
"<div class=""tags"">CSS</div><br>What area of the containing element do floats stay in?"	Content area
"<div class=""tags"">CSS</div><br>Why does an unspecified width defeat the purpose of a <u>float</u>?"	It fills the entire width anyway
"<div class=""tags"">CSS</div><br>What do all floated elements behave like?"	Block elements
"<div class=""tags"">CSS</div><br>What is the highest an element can float?"	Its position in the source
"<div class=""tags"">CSS</div><br>What property prevents an element from being laid out next to a float?"	<u>clear</u>
"<div class=""tags"">CSS</div><br>Can floats overlap?"	No
"<span class=""tags"">CSS</span><br /><br /><br>The default behavior of a float is to <span class=cloze>[...]</span> its containing element"	"<span class=""tags"">CSS</span><br /><br /><br>The default behavior of a float is to <span class=cloze>hang out of</span> its containing element<br><br><br><div class=""extra""></div>"
"<div class=""tags"">CSS</div><br>What property must be specified for every float?"	<u>width</u>
"<div class=""tags"">CSS</div><br>What does relative positioning move a box relative to?"	Its original position
"<div class=""tags"">CSS</div><br>What type of positioning preserves the original space in the document flow?"	Relative
"<div class=""tags"">CSS</div><br>What two types of positioning remove elements from the document flow entirely?"	<u>absolute</u> and <u>fixed</u>
"<div class=""tags"">CSS</div><br>What <u>position</u> value keeps an element in one position on the window?"	<u>fixed</u>
"<div class=""tags"">CSS</div><br>What is the default positioning type?"	<u>static</u>
"<div class=""tags"">CSS</div><br>What does a positioned element have the potential to do?"	Overlap other elements
"<div class=""tags"">CSS</div><br>What is an absolutely positioned element positioned relative to?"	Its nearest containing block.
"<div class=""tags"">CSS</div><br>What is the initial containing element?"	<u>&lt;html&gt;</u>
"<div class=""tags"">CSS</div><br>What is the most common way to make an element a containing block?"	<u>position: relative;</u>
"<span class=""tags"">CSS</span><br /><br /><br>When the containing block is a block element, an absolutely positioned element is placed relative to the <span class=cloze>[...]</span>."	"<span class=""tags"">CSS</span><br /><br /><br>When the containing block is a block element, an absolutely positioned element is placed relative to the <span class=cloze>padding edge</span>.<br><br><br><div class=""extra""></div>"
"<span class=""tags"">CSS</span><br /><br /><br>When the containing block is an inline element, an absolutely positioned element is placed relative to the <span class=cloze>[...]</span>."	"<span class=""tags"">CSS</span><br /><br /><br>When the containing block is an inline element, an absolutely positioned element is placed relative to the <span class=cloze>content edge</span>.<br><br><br><div class=""extra""></div>"
What do absolutely positioned elements behave like?	What do absolutely positioned elements behave like?<br><br><br /><br/><br>Block elements
"<span class=""tags"">CSS</span><br /><br /><br>Responsive web design has three core components: a fluid layout, flexible images, and <span class=cloze>[...]</span>."	"<span class=""tags"">CSS</span><br /><br /><br>Responsive web design has three core components: a fluid layout, flexible images, and <span class=cloze>media queries</span>.<br><br><br><div class=""extra""></div>"
"<span class=""tags"">CSS</span><br /><br /><br>Responsive web design has three core components: a <span class=cloze>[...]</span>, flexible images, and media queries."	"<span class=""tags"">CSS</span><br /><br /><br>Responsive web design has three core components: a <span class=cloze>fluid layout</span>, flexible images, and media queries.<br><br><br><div class=""extra""></div>"
"<span class=""tags"">CSS</span><br /><br /><br>Responsive web design has three core components: a fluid layout, <span class=cloze>[...]</span>, and media queries."	"<span class=""tags"">CSS</span><br /><br /><br>Responsive web design has three core components: a fluid layout, <span class=cloze>flexible images</span>, and media queries.<br><br><br><div class=""extra""></div>"
"<div class=""tags"">CSS</div><br>What declaration makes images scale down to fit the size of their container?"	<u>max-width: 100%;</u>
"<div class=""tags"">CSS</div><br>What is a collection of style rules that creates a neutral starting point called?"	CSS reset
"<div class=""tags"">CSS</div><br>What allows styles to be applied based on screen size?"	A media query
"<div class=""tags"">CSS</div><br>What property acts like a border but doesn't add width?"	<u>outline</u>
"<div class=""tags"">CSS</div><br><!--anki-->What property specifies the stack order of positioned elements?"	<!--anki--><u>z-index</u>
"<div class=""tags"">CSS</div><br>What property specifies the positioning method to be applied to an element?"	<u>position</u>
"<span class=""tags"">CSS</span><br /><br /><br>Margin backgrounds are always <span class=cloze>[...]</span>."	"<span class=""tags"">CSS</span><br /><br /><br>Margin backgrounds are always <span class=cloze>transparent</span>.<br><br><br><div class=""extra""></div>"
"<div class=""tags"">CSS</div><br>What type of element does <u>z-index</u>&nbsp;apply to?"	Positioned
"<div class=""tags"">CSS</div><br>What declaration removes a background color?"	<u>background-color: transparent;</u>
"<div class=""tags"">CSS</div><br>What declaration makes an element invisible?"	<u>visibility: hidden;</u>
"<div class=""tags"">CSS</div><br>CSS: What declaration renders the document as though an element does not exist?"	<u>display: none;</u>
"<div class=""tags"">HTML</div><br>What is the format of an <i>absolute</i> URL?"	<u>scheme</u>://<u>server</u>/<u>path</u>/<u>resource</u>
"<div class=""tags"">HTML</div><br>What does <u>&lt;div&gt;</u> stand for?"	Division element
"<span class=""tags"">CSS</span><br /><br /><br>A <span class=cloze>[...]</span> is a chain of one or more sequences of <b>simple selectors</b> separated by <b>combinators</b>."	"<span class=""tags"">CSS</span><br /><br /><br>A <span class=cloze><b>selector</b></span> is a chain of one or more sequences of <b>simple selectors</b> separated by <b>combinators</b>.<br><br><br><div class=""extra"">Example: <span class=""code"">ul.main &gt; li ul</span>&nbsp;<div><br /><div>This selector has the simple selectors <u>ul</u>, <u>.main</u>, and <u>li</u>. It has the simple selector sequence <u>ul.main</u>, and two combinators, whitespace and <u>&gt;</u>.</div></div></div>"
"<span class=""tags"">CSS</span><br /><br /><br>A <b>selector</b> is a chain of one or more <span class=cloze>[...]</span> of <b>simple selectors</b> separated by <b>combinators</b>."	"<span class=""tags"">CSS</span><br /><br /><br>A <b>selector</b> is a chain of one or more <span class=cloze>sequences</span> of <b>simple selectors</b> separated by <b>combinators</b>.<br><br><br><div class=""extra"">Example: <span class=""code"">ul.main &gt; li ul</span>&nbsp;<div><br /><div>This selector has the simple selectors <u>ul</u>, <u>.main</u>, and <u>li</u>. It has the simple selector sequence <u>ul.main</u>, and two combinators, whitespace and <u>&gt;</u>.</div></div></div>"
"<span class=""tags"">CSS</span><br /><br /><br>A <b>selector</b> is a chain of one or more sequences of <span class=cloze>[...]</span> separated by <b>combinators</b>."	"<span class=""tags"">CSS</span><br /><br /><br>A <b>selector</b> is a chain of one or more sequences of <span class=cloze><b>simple selectors</b></span> separated by <b>combinators</b>.<br><br><br><div class=""extra"">Example: <span class=""code"">ul.main &gt; li ul</span>&nbsp;<div><br /><div>This selector has the simple selectors <u>ul</u>, <u>.main</u>, and <u>li</u>. It has the simple selector sequence <u>ul.main</u>, and two combinators, whitespace and <u>&gt;</u>.</div></div></div>"
"<span class=""tags"">CSS</span><br /><br /><br>A <b>selector</b> is a chain of one or more sequences of <b>simple selectors</b> separated by <span class=cloze>[...]</span>."	"<span class=""tags"">CSS</span><br /><br /><br>A <b>selector</b> is a chain of one or more sequences of <b>simple selectors</b> separated by <span class=cloze><b>combinators</b></span>.<br><br><br><div class=""extra"">Example: <span class=""code"">ul.main &gt; li ul</span>&nbsp;<div><br /><div>This selector has the simple selectors <u>ul</u>, <u>.main</u>, and <u>li</u>. It has the simple selector sequence <u>ul.main</u>, and two combinators, whitespace and <u>&gt;</u>.</div></div></div>"
What happens if a selector in a group of selectors is invalid?	What happens if a selector in a group of selectors is invalid?<br><br><br /><br/><br>The entire group is invalid.
"<span class=""tags"">CSS</span><br /><br /><br>CSS3 has 4 combinators: <span class=cloze>[...]</span>"	"<span class=""tags"">CSS</span><br /><br /><br>CSS3 has 4 combinators: <span class=cloze>whitespace, +, &gt;, and ~</span><br><br><br><div class=""extra""></div>"
"<div class=""tags"">HTML</div><br>Is the <u>type</u>&nbsp;attribute required for <u>&lt;style&gt;</u>&nbsp;in HTML5?"	No
"<div class=""tags"">CSS</div><br>What are the three ways style information can be applied to an HTML document?"	"<ul style=""text-align: left""><li>External style sheets,</li><li>Embedded style sheets, and</li><li>Inline styles</li></ul>"
Who invented the World Wide Web?	Who invented the World Wide Web?<br><br><br /><br/><br>Tim Berners-Lee
When did Tim Berners-Lee invent the World Wide Web?	When did Tim Berners-Lee invent the World Wide Web?<br><br><br /><br/><br>1989
Where was the World Wide Web Consortium founded?	Where was the World Wide Web Consortium founded?<br><br><br /><br/><br>MIT
When was the W3C founded?	When was the W3C founded?<br><br><br /><br/><br>1994
"<span class=""tags"">PHP</span><br /><br /><br>PHP is a <span class=cloze>[...]</span> scripting language designed specifically for the Web."	"<span class=""tags"">PHP</span><br /><br /><br>PHP is a <span class=cloze>server-side</span> scripting language designed specifically for the Web.<br><br><br><div class=""extra""></div>"
"<span class=""tags"">PHP</span><br /><br /><br>PHP is a server-side <span class=cloze>[...]</span> designed specifically for the Web."	"<span class=""tags"">PHP</span><br /><br /><br>PHP is a server-side <span class=cloze>scripting language</span> designed specifically for the Web.<br><br><br><div class=""extra""></div>"
When was PHP conceived?	When was PHP conceived?<br><br><br /><br/><br>1994
Who invented PHP?	Who invented PHP?<br><br><br /><br/><br>Rasmus Lerdorf
"<span class=""tags"">PHP</span><br /><br /><br>PHP code is interpreted at the <span class=cloze>[...]</span>."	"<span class=""tags"">PHP</span><br /><br /><br>PHP code is interpreted at the <span class=cloze>server</span>.<br><br><br><div class=""extra""></div>"
What does PHP stand for?	What does PHP stand for?<br><br><br /><br/><br>PHP: Hypertext Preprocessor
What does RDBMS stand for?	What does RDBMS stand for?<br><br><br /><br/><br>Relational database management system
What is MySQL?	What is MySQL?<br><br><br /><br/><br>An open-source relational database management system.
What does SQL stand for?	What does SQL stand for?<br><br><br /><br/><br>Structured Query Language
What does LAMP stand for?	What does LAMP stand for?<br><br><br /><br/><br>Linux, Apache, MySQL, PHP/Perl/Python
"<div class=""tags"">HTML</div><br>In general, what is the value of a <u>&lt;form&gt;</u>'s <u>action</u>&nbsp;attribute?"	"The URL to be loaded<div><br /></div><div>Example: <font color=""#3db164"">&lt;form method=""get"" </font><font color=""#b12828"">action=""/thanks.php""</font><font color=""#3db164"">&gt;</font></div>"
"<div class=""tags"">HTML</div><br>What attribute specifies how the data in a <u>&lt;form&gt;</u> will be sent?"	<u>method</u>
"<div class=""tags"">HTML</div><br>Which form <u>method</u>&nbsp;appends data to the URL?"	<u>get</u>
"<div class=""tags"">HTML</div><br>Which form <u>method</u>&nbsp;sends data as a separate message?"	<u>post</u>
Is Ruby a high-level or low-level programming language?	Is Ruby a high-level or low-level programming language?<br><br><br /><br/><br>High-level
Is Ruby compiled or interpreted?	Is Ruby compiled or interpreted?<br><br><br /><br/><br>Interpreted
Who designed Ruby?	Who designed Ruby?<br><br><br /><br/><br>Yukihiro Matsumoto
What year was Ruby created?	What year was Ruby created?<br><br><br /><br/><br>1995
"<span class=""tags"">Ruby</span><br /><br /><br>Ruby is designed for programmer <span class=cloze>[...]</span> and <span class=cloze>[...]</span>."	"<span class=""tags"">Ruby</span><br /><br /><br>Ruby is designed for programmer <span class=cloze>productivity</span> and <span class=cloze>fun</span>.<br><br><br><div class=""extra""></div>"
<br>Arrays, booleans and strings are examples of <span class=cloze>[...]</span>.	"<br>Arrays, booleans and strings are examples of <span class=cloze>data types</span>.<br><br><br><div class=""extra""></div>"
<br>In programming, a variable is a name that contains <span class=cloze>[...]</span>.	"<br>In programming, a variable is a name that contains <span class=cloze>a single value</span>.<br><br><br><div class=""extra""></div>"
"<div class=""tags"">Ruby</div><br>Ruby: Declare a variable <u>chunky</u> with a value of <u>5</u>."	<u>chunky = 5</u>
What are the following arithmetic operators in Ruby? + &nbsp;- &nbsp;* &nbsp;/ &nbsp;** &nbsp;%	What are the following arithmetic operators in Ruby? + &nbsp;- &nbsp;* &nbsp;/ &nbsp;** &nbsp;%<br><br><br /><br/><br>Addition, Subtraction, Multiplication, Division, Exponentiation and Modulo
"<div class=""tags"">Ruby</div><br>What does <u>puts</u> stand for?"	Put String
"<div class=""tags"">Ruby</div><br>What Ruby command prints whatever you give it to the screen?"	<u>print</u>
"<div class=""tags"">Ruby</div><br>What does <u>puts</u>&nbsp;do differently from <u>print</u>?"	Adds a newline
"<span class=""tags"">Ruby</span><br /><br /><br>(Almost) everything in Ruby is an <span class=cloze>[...]</span>."	"<span class=""tags"">Ruby</span><br /><br /><br>(Almost) everything in Ruby is an <span class=cloze>object</span>.<br><br><br><div class=""extra"">*With the exception of blocks</div>"
"<div class=""tags"">Ruby</div><br>What is the program that runs the code you write?"	The interpreter
"<span class=""tags"">Ruby</span><br /><br /><br>Methods are called using a <span class=cloze>[...]</span>"	"<span class=""tags"">Ruby</span><br /><br /><br>Methods are called using a <span class=cloze><b>.</b></span><br><br><br><div class=""extra""></div>"
"<div class=""tags"">Ruby</div><br>Which method returns the length of a string?"	<u>.length</u>
"<div class=""tags"">Ruby</div><br>What method reverses the order of a string?"	<u>.reverse</u>
"<div class=""tags"">Ruby</div><br>Which methods convert a string to upper and lower case?"	<u>.upcase</u>&nbsp;and <u>.downcase</u>
"<div class=""tags"">Ruby</div><br>What denotes a single-line comment in Ruby?"	<u>#</u>
"<div class=""tags"">Ruby</div><br>What are multi-line comments enclosed by in Ruby?"	<u>=begin</u>&nbsp;and <u>=end</u>
"<span class=""tags"">Ruby</span><br /><br /><br>By convention, variables should start with a <span class=cloze>[...]</span> and words should be separated by underscores."	"<span class=""tags"">Ruby</span><br /><br /><br>By convention, variables should start with a <span class=cloze>lowercase letter</span> and words should be separated by underscores.<br><br><br><div class=""extra"">Examples: <span class=""code"">counter</span> and <span class=""code"">masterful_method</span></div>"
"<span class=""tags"">Ruby</span><br /><br /><br>By convention, variables should start with a lowercase letter and words should be separated by <span class=cloze>[...]</span>."	"<span class=""tags"">Ruby</span><br /><br /><br>By convention, variables should start with a lowercase letter and words should be separated by <span class=cloze>underscores</span>.<br><br><br><div class=""extra"">Examples: <span class=""code"">counter</span> and <span class=""code"">masterful_method</span></div>"
"<div class=""tags"">Ruby</div><br>What method gets input from the user?"	<u>gets</u>
"<span class=""tags"">Ruby</span><br /><br /><br>When getting input, Ruby automatically adds a <span class=cloze>[...]</span> after each bit of input."	"<span class=""tags"">Ruby</span><br /><br /><br>When getting input, Ruby automatically adds a <span class=cloze>newline</span> after each bit of input.<br><br><br><div class=""extra""></div>"
"<div class=""tags"">Ruby</div><br>Which Ruby method removes the extra line from input?"	<u>.chomp</u>
"<div class=""tags"">Ruby</div><br>Does Ruby care about whitespace?"	No
"<span class=""tags"">Ruby</span><br /><br /><br>Use <span class=cloze>[...]</span> to check if something is true and <span class=cloze>[...]</span> to check if something is false."	"<span class=""tags"">Ruby</span><br /><br /><br>Use <span class=cloze><span class=""code"">if</span></span> to check if something is true and <span class=cloze><span class=""code"">unless</span></span> to check if something is false.<br><br><br><div class=""extra""></div>"
"<span class=""tags"">Ruby</span><br /><br /><br>Use <span class=""code"">if</span> to check if something is <span class=cloze>[...]</span> and <span class=""code"">unless</span> to check if something is <span class=cloze>[...]</span>."	"<span class=""tags"">Ruby</span><br /><br /><br>Use <span class=""code"">if</span> to check if something is <span class=cloze>true</span> and <span class=""code"">unless</span> to check if something is <span class=cloze>false</span>.<br><br><br><div class=""extra""></div>"
<br>What do <u>==</u>&nbsp;and <u>!=</u>&nbsp;mean?	Equal and not equal
"<div class=""tags"">Ruby</div><br>What are the three boolean operators in Ruby?"	<u>&amp;&amp;</u>,<u>||</u>&nbsp;and <u>!</u>&nbsp;(and, or and not)
"<div class=""tags"">Ruby</div><br>What are the relational operators in Ruby?"	<u>==</u>, <u>!=</u>, <u>&lt;</u>, <u>&lt;=</u>, <u>&gt;</u>, and&nbsp;<u>&gt;=</u><div><u><br /></u></div><div>They compare the <i>relationships</i>&nbsp;between values.</div>
"<span class=""tags"">Ruby</span><br /><br /><br>The <span class=cloze>[...]</span> operator returns the remainder of a division."	"<span class=""tags"">Ruby</span><br /><br /><br>The <span class=cloze>modulo</span> operator returns the remainder of a division.<br><br><br><div class=""extra"">Example: 8 % 3 = 2</div>"
"<div class=""tags"">Ruby</div><br>What is analogous to an object's skill in Ruby?"	A method
"<div class=""tags"">Ruby</div><br>In Ruby, which conditional essentially means <i>otherwise</i>?"	<u>else</u>
<br>Which conditional specifies what to do if no other conditions are met?	<u>else</u>
"<div class=""tags"">Ruby</div><br><img src=""matz.png"" /><div><br /></div><div>Who is this man?</div>"	Yukihiro Matsumoto
"<div class=""tags"">Ruby</div><br>What does <u>gsub</u>&nbsp;stand for?"	Global substitution
"<div class=""tags"">Ruby</div><br>Which method replaces all&nbsp;<font color=""#005500"">substrings</font> with another&nbsp;<font color=""#005500"">substring</font>?"	<u>.gsub</u>&nbsp;( global substitution )
"<div class=""tags"">Ruby</div><br>What syntax interpolates the variable&nbsp;<u>my_string</u>?"	<u>#{my_string}</u>
"<div class=""tags"">Programming</div><br>What is it called when you insert an expression into a string?"	"String interpolation.<example><lang class=""r"">Ruby</lang><div><u>walnuts = 143</u></div><div><u>puts ""I have #{walnuts} walnuts.""</u></div></example><br /><div><u>I have 143 walnuts.</u></div>"
<br>What kind of loop will cause your programs to crash?	"An infinite loop.<example><font color=""#507c96"">while</font> <font color=""#ad3e3e"">i</font> <font color=""#507c96"">&lt;</font> <font color=""#1eaa92"">5</font> <font color=""#507c96"">do</font><div>&nbsp; <font color=""#ad3e3e"">i</font> <font color=""#507c96"">-=</font> <font color=""#1eaa92"">1</font></div><div><font color=""#507c96"">end</font></div></example>"
"<div class=""tags"">Ruby</div><br>Which loop repeats while a condition is true?"	<u>while</u>
"<div class=""tags"">Ruby</div><br>Which loop acts as a backwards <u>while</u>?"	<u>until</u>
"<div class=""tags"">Ruby</div><br>What kind of operator changes the value of a variable?"	An assignment operator.<example><div><u>duck = 4</u>&nbsp; &nbsp; &nbsp; # duck is 4</div><div><u>duck += 10</u>&nbsp; &nbsp; # duck is now 14</div><div><u>duck *= 1.3</u>&nbsp; &nbsp;# now duck is 15.2</div></example>
"<div class=""tags"">Ruby</div><br>Does Ruby have increment operators?"	No
"<div class=""tags"">Ruby</div><br>What type of operators are <u>++</u> and <u>--</u>?"	Increment operators.
"<div class=""tags"">Ruby</div><br>What do increment operators do?"	Add or subtract 1 from a value.
"<div class=""tags"">Ruby</div><br>What loop is used when you know how many times you'll be looping?"	<u>for</u>
"<span class=""tags"">Ruby</span><br /><br /><br>In Ruby, an inclusive range has <span class=cloze>[...]</span> dots and an exclusive range has <span class=cloze>[...]</span>."	"<span class=""tags"">Ruby</span><br /><br /><br>In Ruby, an inclusive range has <span class=cloze>two</span> dots and an exclusive range has <span class=cloze>three</span>.<br><br><br><div class=""extra"">Example:&nbsp;<div><span class=""code"">1..10</span> would include 10</div><div><span class=""code"">1...10</span> would only go up to 9</div></div>"
"<div class=""tags"">Ruby</div><br>What is the Ruby syntax for an exclusive range between 6 and 18?"	"<u><font color=""#b06b0a"">6</font>...<font color=""#b06b0a"">18</font></u>"
"<div class=""tags"">Ruby</div><br>What is the Ruby syntax for an inclusive range between 2 and 98?"	"<u><font color=""#b06b0a"">2</font><font color=""#ba0a48"">..</font><font color=""#b06b0a"">98</font></u>"
"<div class=""tags"">Ruby</div><br>What is a Ruby method that repeatedly invokes a block of code?"	An iterator
"<div class=""tags"">Ruby</div><br>What keyword can be used to skip over certain steps in a loop?"	<u>next</u>
"<div class=""tags"">Ruby</div><br>In Ruby, braces are generally interchangeable with which two keywords?"	<u>do</u>&nbsp;and <u>end</u>
"<div class=""tags"">Ruby</div><br>What keyword ends a loop as soon as a condition is met?"	<u>break</u>
"<div class=""tags"">Ruby</div><br>What is a list of items between brackets?"	"An array.<div><br /></div><div>Example: <u>[<font color=""#249e42"">""cat""</font>, <font color=""#1eaa92"">5</font>, <font color=""#249e42"">""bird""</font>, <font color=""#249e42"">""etc""</font>]</u></div>"
"<div class=""tags"">Ruby</div><br>Which method can apply an expression to each element of an object?"	<u>.each</u><div><u><br /></u></div><div>Syntax: <u>object.each { |item| # do something }</u></div>
"<div class=""tags"">Ruby</div><br>For the <u>.each</u>&nbsp;method, what does the variable between <u>| |</u>&nbsp;function as?"	A <b>placeholder</b>.
"<div class=""tags"">Ruby</div><br>Which method can execute a block a specified number of times?"	"<u>.times</u><div><u><br /></u></div><div>Example: <u>10.times { print ""Chunky Bacon!"" }</u></div>"
"<span class=""tags"">Ruby</span><br /><br /><br>The <span class=""code"">split</span> method takes in a <span class=cloze>[...]</span> and returns an array."	"<span class=""tags"">Ruby</span><br /><br /><br>The <span class=""code"">split</span> method takes in a <span class=cloze>string</span> and returns an array.<br><br><br><div class=""extra""></div>"
"<span class=""tags"">Ruby</span><br /><br /><br>The <span class=""code"">split</span> method takes in a string and returns an <span class=cloze>[...]</span>."	"<span class=""tags"">Ruby</span><br /><br /><br>The <span class=""code"">split</span> method takes in a string and returns an <span class=cloze>array</span>.<br><br><br><div class=""extra""></div>"
"<div class=""tags"">Ruby</div><br>Which Ruby method will divide a string wherever it finds a delimiter?"	<u>.split</u>
<br>Each element in an array is referenced by an <span class=cloze>[...]</span>.	"<br>Each element in an array is referenced by an <span class=cloze>index</span>.<br><br><br><div class=""extra""></div>"
"<div class=""tags"">PHP Ruby</div><br>What number does an array index start at?"	<u>0</u>
"<div class=""tags"">Ruby</div><br>What Ruby syntax accesses element <u>i</u> of an array?"	<u>array[i]</u>
"<div class=""tags"">Ruby</div><br>What is it called when you access an element of an array by its index?"	Access by index
"<div class=""tags"">Ruby</div><br>What is an array of arrays called?"	A multidimensional array.
"<div class=""tags"">PHP Ruby</div><br>For an array of length<b>&nbsp;n</b>, what is the index of the last element?"	<b>n-1</b><div><u><br /></u></div><div>This is because arrays start at 0.</div>
"<span class=""tags"">Ruby</span><br /><br /><br>A hash is a collection of <span class=cloze>[...]</span>."	"<span class=""tags"">Ruby</span><br /><br /><br>A hash is a collection of <span class=cloze>key-value pairs</span>.<br><br><br><div class=""extra""><span class=""code""><br /></span></div>"
"<span class=""tags"">Ruby</span><br /><br /><br>A <span class=cloze>[...]</span> is a collection of key-value pairs."	"<span class=""tags"">Ruby</span><br /><br /><br>A <span class=cloze>hash</span> is a collection of key-value pairs.<br><br><br><div class=""extra""><span class=""code""><br /></span></div>"
"<div class=""tags"">Ruby</div><br>In Ruby, what symbol assigns a hash value to a key?"	<u>=&gt;</u>
"<div class=""tags"">Ruby</div><br>What hash notation is this?<div><br /></div><example>hash = {<div>&nbsp; key1 =&gt; value1,</div><div>&nbsp; key2 =&gt; value2,</div><div>&nbsp; key3 =&gt; value3</div><div>}</div></example>"	Literal notation
"<div class=""tags"">Ruby</div><br>What syntax creates a new, empty hash?"	"<u><font color=""#b06b0a"">Hash</font><font color=""#ba0a48"">.new</font></u>"
"<div class=""tags"">Ruby</div><br>What syntax adds the key <u>:vale</u>&nbsp;with the value <u>""genius""</u>&nbsp;to the hash <u>people</u>?"	"<u>people[:vale] = ""genius""</u>"
"<span class=""tags"">Programming</span><br /><br /><br>When we loop over an array or a hash, we say that we <span class=cloze>[...]</span> over it."	"<span class=""tags"">Programming</span><br /><br /><br>When we loop over an array or a hash, we say that we <span class=cloze>iterate</span> over it.<br><br><br><div class=""extra""></div>"
"<span class=""tags"">Ruby</span><br /><br /><br>When iterating over hashes, you need <span class=cloze>[...]</span> to represent each key/value pair."	"<span class=""tags"">Ruby</span><br /><br /><br>When iterating over hashes, you need <span class=cloze>two placeholder variables</span> to represent each key/value pair.<br><br><br><div class=""extra"">Example:<code><div>restaurant_menu.each do |item, price|</div><div>&nbsp; puts ""#{item}: #{price}""</div><div>end</div></code></div>"
"<div class=""tags"">Ruby</div><br>What should a hash include in case a non-existent key is accessed?"	"A <b>default value.</b><div><b><br /></b></div><div>Example: <font color=""#b06b0a"">Hash</font><font color=""#ba0a48"">.new</font>(<font color=""#005500"">""This would show by default.""</font>)</div>"
"<div class=""tags"">Ruby</div><br>Which method converts a value to a string?"	<u>.to_s</u>
<br>What word means to combine strings?	Concatenate
"<span class=""tags"">Ruby</span><br /><br /><br><span class=cloze>[...]</span> are called functions in other programming languages."	"<span class=""tags"">Ruby</span><br /><br /><br><span class=cloze>Methods</span> are called functions in other programming languages.<br><br><br><div class=""extra""></div>"
"<div class=""tags"">Ruby</div><br>What can you create in Ruby to:&nbsp;<div>1. make bugs easier to find &amp; fix,&nbsp;</div><div>2. make your program less redundant,&nbsp;</div><div>3. and your code more reusable?</div>"	A <b>method</b>
"<div class=""tags"">Ruby</div><br>Which keyword defines a method?"	<u>def</u>
"<div class=""tags"">Ruby</div><br>What is <u>def</u>&nbsp;short for?"	Define
"<div class=""tags"">Ruby</div><br>How many parts does a method have?"	Three. (header, body, <u>end</u> keyword)
"<div class=""tags"">Ruby</div><br>What is the first part of a method?"	"The header.<example>def <font color=""#ba0a48"">function</font>(&nbsp;<font color=""#ba0a48"">parameter&nbsp;</font>)</example>"
"<span class=""tags"">Ruby</span><br /><br /><br>A method's header includes the <span class=cloze>[...]</span>, the method name, and any arguments the method takes."	"<span class=""tags"">Ruby</span><br /><br /><br>A method's header includes the <span class=cloze><code>def</code> keyword</span>, the method name, and any arguments the method takes.<br><br><br><div class=""extra""></div>"
"<span class=""tags"">Ruby</span><br /><br /><br>A method's header includes the <code>def</code> keyword, the <span class=cloze>[...]</span>, and any arguments the method takes."	"<span class=""tags"">Ruby</span><br /><br /><br>A method's header includes the <code>def</code> keyword, the <span class=cloze>method name</span>, and any arguments the method takes.<br><br><br><div class=""extra""></div>"
"<span class=""tags"">Ruby</span><br /><br /><br>A method's header includes the <code>def</code> keyword, the method name, and any <span class=cloze>[...]</span> the method takes."	"<span class=""tags"">Ruby</span><br /><br /><br>A method's header includes the <code>def</code> keyword, the method name, and any <span class=cloze>arguments</span> the method takes.<br><br><br><div class=""extra""></div>"
"<div class=""tags"">Ruby</div><br>What is the second part of a method?"	The body
"<div class=""tags"">Ruby</div><br>A method body is the code block that describes what?"	What the method <i>does</i>.
"<div class=""tags"">Ruby</div><br>What does a method end with?"	The keyword <u>end</u>
"<span class=""tags"">Ruby</span><br /><br /><br>When you <span class=cloze>[...]</span> a method, Ruby will look for and execute its code."	"<span class=""tags"">Ruby</span><br /><br /><br>When you <span class=cloze>call</span> a method, Ruby will look for and execute its code.<br><br><br><div class=""extra""></div>"
"<span class=""tags"">Ruby</span><br /><br /><br>When you call a method, Ruby will look for and <span class=cloze>[...]</span> its code."	"<span class=""tags"">Ruby</span><br /><br /><br>When you call a method, Ruby will look for and <span class=cloze>execute</span> its code.<br><br><br><div class=""extra""></div>"
"<div class=""tags"">Ruby</div><br>How do you call a method?"	By typing its name.
"<div class=""tags"">Ruby</div><br>What is the piece of code you put between a method's parentheses when you <i>call</i>&nbsp;it?"	An argument<b>.</b>
"<div class=""tags"">Ruby</div><br>What do you put between a method's parentheses when you <b>define</b>&nbsp;it?"	A&nbsp;<b>parameter.</b>
"<span class=""tags"">Ruby</span><br /><br /><br>If a method takes <b>arguments</b>, we say it <span class=cloze>[...]</span> or <span class=cloze>[...]</span> those arguments."	"<span class=""tags"">Ruby</span><br /><br /><br>If a method takes <b>arguments</b>, we say it <span class=cloze>accepts</span> or <span class=cloze>expects</span> those arguments.<br><br><br><div class=""extra""></div>"
"<div class=""tags"">Ruby</div><br>What is the parameter in:<example><div><code><u><font color=""#aa00ff"">def</font> <font color=""#a20c4d"">square</font></u><u>(<font color=""#a20c4d"">n</font>)</u></code></div><div><u><font color=""#ff55ff"">&nbsp; </font><font color=""#a20c4d"">puts n **</font> <font color=""#b06b0a"">2</font></u></div><div><u><font color=""#aa00ff"">end</font></u></div></example>"	"<u><font color=""#a20c4d"">n</font></u>"
"<div class=""tags"">Ruby</div><br>What is the argument in:<div><code><u><font color=""#a20c4d"">square</font></u></code><u>(<font color=""#b06b0a"">16</font>)</u>?</div>"	"<u><font color=""#b06b0a"">16</font></u>"
"<span class=""tags"">Ruby</span><br /><br /><br>Parentheses are usually <span class=cloze>[...]</span> in Ruby."	"<span class=""tags"">Ruby</span><br /><br /><br>Parentheses are usually <span class=cloze>optional</span> in Ruby.<br><br><br><div class=""extra"">But it's a good idea to use them for readability.</div>"
"<div class=""tags"">Ruby</div><br>What type of argument tells Ruby there could be more than one of itself?"	"A splat argument.<div><br /></div><div>Example <u>*bros</u>:</div><example><div><u><font color=""#aa00ff"">def</font> <font color=""#55557f"">what_up(greeting, <b>*bros</b>)</font></u></div><div><u><font color=""#55557f"">&nbsp; bros.each { |bro|</font> <font color=""#0000ff"">puts</font> <font color=""#005500"">""#{greeting}, #{bro}!""</font> <font color=""#55557f"">}</font><br /></u></div><div><u><font color=""#aa00ff"">end</font></u></div></example>"
"<div class=""tags"">Ruby</div><br>What keyword tells a method to hand a value back to you?"	"<u>return</u><div><u><br /></u></div><div>Example:</div><example><u><font color=""#aa00ff"">def</font> <font color=""#ba0a48"">double</font>(<font color=""#ba0a48"">n</font>)</u><div><u>&nbsp; <font color=""#aa00ff"">return</font> <font color=""#ba0a48"">n</font> * <font color=""#b06b0a"">2</font></u></div><div><u><font color=""#aa00ff"">end</font></u></div></example>"
"<div class=""tags"">Ruby</div><br>What operator compares two Ruby objects?"	The <b>combined comparison operator</b>. ( <u>&lt;=&gt;</u> )
"<div class=""tags"">Ruby</div><br>What does the combined comparison operator look like?"	<u>&lt;=&gt;</u>
"<span class=""tags"">Ruby</span><br /><br /><br>The combined comparison operator returns:&nbsp;<div><span class=cloze>[...]</span> if the first operand == the second,</div><div><span class=cloze>[...]</span> if the first operand &gt; the second,</div><div>and <span class=cloze>[...]</span> if the first operand &lt; the second.</div>"	"<span class=""tags"">Ruby</span><br /><br /><br>The combined comparison operator returns:&nbsp;<div><span class=cloze>0</span> if the first operand == the second,</div><div><span class=cloze>1</span> if the first operand &gt; the second,</div><div>and <span class=cloze>-1</span> if the first operand &lt; the second.</div><br><br><br><div class=""extra""><example><font color=""#1eaa92"">3</font> <font color=""#333333"">&lt;=&gt;</font> <font color=""#f4c364"">3.0</font> <font color=""#333333"">=&gt;</font><font color=""#5555ff""> &nbsp;</font><font color=""#1eaa92"">0</font><div><font color=""#1eaa92"">2</font> <font color=""#333333"">&lt;=&gt;</font> <font color=""#1eaa92"">1</font> &nbsp; <font color=""#333333"">=&gt;</font><font color=""#5555ff""> &nbsp;</font><font color=""#1eaa92"">1</font></div><div><font color=""#1eaa92"">5</font> <font color=""#333333"">&lt;=&gt;</font> <font color=""#1eaa92"">7</font> &nbsp; <font color=""#333333"">=&gt;</font><font color=""#5555ff""> </font><font color=""#1eaa92"">-1</font></div></example></div>"
"<span class=""tags"">Ruby</span><br /><br /><br>The combined comparison operator returns:&nbsp;<div>0 if the first operand <span class=cloze>[...]</span> the second,</div><div>1 if the first operand <span class=cloze>[...]</span> the second,</div><div>and -1 if the first operand <span class=cloze>[...]</span> the second.</div>"	"<span class=""tags"">Ruby</span><br /><br /><br>The combined comparison operator returns:&nbsp;<div>0 if the first operand <span class=cloze>==</span> the second,</div><div>1 if the first operand <span class=cloze>&gt;</span> the second,</div><div>and -1 if the first operand <span class=cloze>&lt;</span> the second.</div><br><br><br><div class=""extra""><example><font color=""#1eaa92"">3</font> <font color=""#333333"">&lt;=&gt;</font> <font color=""#f4c364"">3.0</font> <font color=""#333333"">=&gt;</font><font color=""#5555ff""> &nbsp;</font><font color=""#1eaa92"">0</font><div><font color=""#1eaa92"">2</font> <font color=""#333333"">&lt;=&gt;</font> <font color=""#1eaa92"">1</font> &nbsp; <font color=""#333333"">=&gt;</font><font color=""#5555ff""> &nbsp;</font><font color=""#1eaa92"">1</font></div><div><font color=""#1eaa92"">5</font> <font color=""#333333"">&lt;=&gt;</font> <font color=""#1eaa92"">7</font> &nbsp; <font color=""#333333"">=&gt;</font><font color=""#5555ff""> </font><font color=""#1eaa92"">-1</font></div></example></div>"
"<div class=""tags"">Ruby</div><br>Can a parameter have a default value?"	"Yes.<div><br /></div><div>Example:</div><div><u><font color=""#aa00ff"">def</font> <font color=""#ba0a48"">power</font> (<font color=""#ba0a48"">num</font>, <font color=""#ba0a48"">exp</font>=<font color=""#b06b0a"">2</font>)</u></div><div><u>&nbsp; <font color=""#aa00ff"">return</font> <font color=""#ba0a48"">num</font> ** <font color=""#ba0a48"">exp</font></u></div><div><u><font color=""#aa00ff"">end</font></u></div>"
"<span class=""tags"">Ruby</span><br /><br /><br>Within a hash, keys must be <span class=cloze>[...]</span>, but values can <span class=cloze>[...]</span>."	"<span class=""tags"">Ruby</span><br /><br /><br>Within a hash, keys must be <span class=cloze>unique</span>, but values can <span class=cloze>repeat</span>.<br><br><br><div class=""extra""></div>"
"<span class=""tags"">Ruby</span><br /><br /><br>Within a hash, <span class=cloze>[...]</span> must be unique, but <span class=cloze>[...]</span> can repeat."	"<span class=""tags"">Ruby</span><br /><br /><br>Within a hash, <span class=cloze>keys</span> must be unique, but <span class=cloze>values</span> can repeat.<br><br><br><div class=""extra""></div>"
"<div class=""tags"">Ruby</div><br>What hash notation is this?<div><br /></div><div><u>new_hash = Hash.new</u></div>"	Constructor notation
"<div class=""tags"">Ruby</div><br>What special value is returned if a key doesn't exist?"	<u>nil</u>
"<div class=""tags"">Ruby</div><br>What are the two non-<u>true</u>&nbsp;values in Ruby?"	<u>false</u>&nbsp;and <u>nil</u>
"<span class=""tags"">Ruby</span><br /><br /><br>In Ruby, every object except for <code>false</code> and <code>nil</code> is regarded as <span class=cloze>[...]</span>."	"<span class=""tags"">Ruby</span><br /><br /><br>In Ruby, every object except for <code>false</code> and <code>nil</code> is regarded as <span class=cloze>truthy</span>.<br><br><br><div class=""extra""></div>"
"<div class=""tags"">Ruby</div><br>What is a non-boolean that counts as <u>true</u>&nbsp;called?"	Truthy
"<div class=""tags"">Ruby</div><br>What is a non-boolean that counts as <u>false</u>&nbsp;called?"	Falsey
"<div class=""tags"">Ruby</div><br>Is <u>nil</u>&nbsp;a boolean?"	No. Only <u>true</u>&nbsp;and <u>false</u>&nbsp;are booleans.
"<div class=""tags"">Ruby</div><br>What Ruby object looks like a colon followed by characters?"	A <b>symbol</b>.
"<span class=""tags"">Ruby</span><br /><br /><br>A Ruby symbol is a <i>thing</i>&nbsp;that has both a <span class=cloze>[...]</span> and a <span class=cloze>[...]</span>."	"<span class=""tags"">Ruby</span><br /><br /><br>A Ruby symbol is a <i>thing</i>&nbsp;that has both a <span class=cloze>number</span> and a <span class=cloze>string</span>.<br><br><br><div class=""extra"">Example: <code>:month, :books_read</code></div>"
"<span class=""tags"">Ruby</span><br /><br /><br>A Ruby <span class=cloze>[...]</span> is a <i>thing</i>&nbsp;that has both a number and a string."	"<span class=""tags"">Ruby</span><br /><br /><br>A Ruby <span class=cloze>symbol</span> is a <i>thing</i>&nbsp;that has both a number and a string.<br><br><br><div class=""extra"">Example: <code>:month, :books_read</code></div>"
"<div class=""tags"">Ruby</div><br>What is the value of a Ruby symbol's string part?"	"The <b>name</b> of the symbol <b>minus</b> the colon.<div><br /></div><div>Examples:</div><div><u>:red</u> =&gt; <u>""red""</u></div><div><u>:'an example'</u> =&gt; <u>""an example""</u></div>"
"<div class=""tags"">Ruby</div><br>Can a symbol be changed at runtime?"	No.
"<span class=""tags"">Ruby</span><br /><br /><br>Symbols are useful for <span class=cloze>[...]</span> modification."	"<span class=""tags"">Ruby</span><br /><br /><br>Symbols are useful for <span class=cloze>preventing</span> modification.<br><br><br><div class=""extra""></div>"
"<span class=""tags"">Ruby</span><br /><br /><br>The only thing that a symbol needs syntactically is a <span class=cloze>[...]</span> prepended."	"<span class=""tags"">Ruby</span><br /><br /><br>The only thing that a symbol needs syntactically is a <span class=cloze>colon</span> prepended.<br><br><br><div class=""extra""></div>"
"<div class=""tags"">Ruby</div><br>Which method allows you to add an element to the end of an array?"	"<u>.push</u><example><font color=""#ad3e3e"">strings</font> = [<font color=""#249e42"">""HTML""</font>, <font color=""#249e42"">""CSS""</font>, <font color=""#249e42"">""Ruby""</font>]<div><font color=""#ad3e3e"">symbols</font> = []</div><div><font color=""#ad3e3e"">strings</font><font color=""#507c96"">.each do</font> |<font color=""#ad3e3e"">s</font>|</div><div>&nbsp; <font color=""#ad3e3e"">symbols</font><font color=""#507c96"">.push</font> <font color=""#ad3e3e"">s</font><font color=""#507c96"">.to_sym</font></div><div><font color=""#507c96"">end</font></div></example>"
"<div class=""tags"">Ruby</div><br>Which two methods convert strings to symbols?"	<u>.to_sym</u>&nbsp;and <u>.intern</u>
"<div class=""tags"">Ruby</div><br>When using symbols as hash keys, where should the colon go?"	At the <b>end</b>&nbsp;of the symbol.<div><br /></div><div>Example:</div><example><u>new_hash = {</u><div><u>&nbsp; one: 1,</u></div><div><u>&nbsp; two: 2,</u></div><div><u>&nbsp; three: 3</u></div><div><u>}</u></div></example><br /><div>All three keys are regarded as <b>symbols</b>.</div>
"<div class=""tags"">Ruby</div><br>Which is faster: symbols or strings?"	Symbols.
"<div class=""tags"">Ruby</div><br>Which uses less memory in Ruby: symbols or strings?"	Symbols.
"<div class=""tags"">Ruby</div><br>Which Ruby method can filter an object for values that meet certain criteria?"	"<u>.select</u><div><u><br /></u></div><div>Example:</div><div><u><font color=""#ba0a48"">grades</font> = { <font color=""#ba0a48"">alice</font>: <font color=""#b06b0a"">100</font>,</u></div><div><u>&nbsp; <font color=""#ba0a48"">bob</font>: <font color=""#b06b0a"">92</font>,</u></div><div><u>&nbsp; <font color=""#ba0a48"">chris</font>: <font color=""#b06b0a"">95</font>,</u></div><div><u>&nbsp; <font color=""#ba0a48"">dave</font>: <font color=""#b06b0a"">97</font></u></div><div><u>}</u></div><div><u><br /></u></div><div><u><font color=""#ba0a48"">grades</font>.<font color=""#ba0a48"">select</font> { |<font color=""#ba0a48"">name</font>, <font color=""#ba0a48"">grade</font>| <font color=""#ba0a48"">grade</font> &lt; <font color=""#b06b0a"">97</font> }</u></div><div><u># ==&gt; { :bob=&gt;92, :chris=&gt;95 }</u></div>"
"<div class=""tags"">Ruby</div><br>Which two Ruby methods can iterate over <i>just</i>&nbsp;keys or <i>just</i>&nbsp;values?"	"<u>.each_key</u>&nbsp;and <u>.each_value</u><div><u><br /></u></div><div>Example:</div><div><u><font color=""#ba0a48"">my_hash</font>.<font color=""#ba0a48"">each_value</font> { |<font color=""#ba0a48"">v</font>| <font color=""#ba0a48"">print v</font>, <font color=""#005500"">"" ""</font> }</u></div>"
"<div class=""tags"">Ruby</div><br>What statement provides a concise alternative to <u>if</u>/<u>elsif</u>s?"	<u>case</u>
"<div class=""tags"">Programming</div><br>What does <b>CRUD</b>&nbsp;stand for?"	Create, Read, Update, Delete
"<div class=""tags"">Ruby</div><br>Do you need an <u>end</u>&nbsp;for a one-line <u>if</u>&nbsp;statement?"	"No<div><br /></div><div>Example:</div><div><u><font color=""#ba0a48"">puts</font> <font color=""#005500"">""It's true""</font> <font color=""#aa00ff"">if true</font></u></div>"
"<div class=""tags"">Ruby</div><br>Which more concise form of an <u>if</u>/<u>else</u>&nbsp;statement has the syntax <u>a ? b : c</u>"	The ternary operator.
"<div class=""tags"">Ruby</div><br>In a <u>case</u>&nbsp;statement, what keyword can you use to make a condition one line?"	"<u>then</u><div><u><br /></u></div><div>Example:</div><div><u><font color=""#aa00ff"">case</font> <font color=""#ba0a48"">language</font></u></div><div><u><font color=""#aa00ff"">when</font> <font color=""#005500"">""HTML""</font> <font color=""#aa00ff"">then</font> <font color=""#ba0a48"">puts</font> <font color=""#005500"">""Websites!""</font></u></div><div><u><font color=""#aa00ff"">when</font> <font color=""#005500"">""C++""</font> <font color=""#aa00ff"">then</font> <font color=""#ba0a48"">puts</font> <font color=""#005500"">""Fast!""</font></u></div><div><u><font color=""#aa00ff"">when</font> <font color=""#005500"">""Ruby""</font> <font color=""#aa00ff"">then</font> <font color=""#ba0a48"">puts</font> <font color=""#005500"">""Elegant!""</font></u></div><div><u><font color=""#aa00ff"">end</font></u></div>"
"<div class=""tags"">Ruby</div><br>What operator is used to assign a variable only if it hasn't already been assigned?"	The <b>conditional assignment operator</b>&nbsp;( <u>||=</u>&nbsp;)
"<div class=""tags"">Ruby</div><br>What is the syntax for the conditional assignment operator?"	<u>||=</u>
"<div class=""tags"">Ruby</div><br>What do methods in Ruby implicitly <u>return</u>?"	The result of the <b>last evaluated expression.</b>
"<div class=""tags"">Ruby</div><br>Which Ruby operator adds an element to the end of an array or string?"	The <b>concatenation operator</b>&nbsp;( <u>&lt;&lt;</u>&nbsp;)
<br>What word means to improve the structure of your code without changing what it does?	Refactor
"<div class=""tags"">Ruby</div><br>Which two methods take a block and apply it to every element in an <i>array</i>?"	<u>.map</u>&nbsp;and <u>.collect</u>&nbsp;(they're synonyms)
"<div class=""tags"">Ruby</div><br>A method<!--anki-->&nbsp;using which keyword&nbsp;will accept a block?"	"<u>yield</u><example><lang class=""r"">Ruby</lang><div><u><div>def test</div><div>&nbsp; &nbsp;puts ""You are in the method""</div><div>&nbsp; &nbsp;yield</div><div>&nbsp; &nbsp;puts ""You are again back to the method""</div><div>&nbsp; &nbsp;yield</div><div>end</div><div>test {puts ""You are in the block""}</div></u></div></example><br><div><br /></div><div><div>You are in the method</div><div>You are in the block</div><div>You are again back to the method</div><div>You are in the block</div></div>"
"<div class=""tags"">Ruby</div><br>Which Ruby object is essentially a saved code block?"	A proc.
"<div class=""tags"">Ruby</div><br>What does <u>proc</u>&nbsp;stand for?"	Procedure Object
"<span class=""tags"">Ruby</span><br /><br /><br>Keeping your code <b>DRY</b>&nbsp;means <span class=cloze>[...]</span>."	"<span class=""tags"">Ruby</span><br /><br /><br>Keeping your code <b>DRY</b>&nbsp;means <span class=cloze>don't repeat yourself</span>.<br><br><br><div class=""extra""></div>"
"<div class=""tags"">Ruby</div><br>Which method does the exact same thing as <u>.collect</u>?"	<u>.map</u>
"<div class=""tags"">Ruby</div><br>What symbol converts a proc to a block (and vice versa)?"	<u>&amp;</u>
"<div class=""tags"">Ruby</div><br>Which methods round a float up or down to the nearest integer?"	"<u>.ceil</u>&nbsp;and <u>.floor</u><div><u><br /></u></div><div>Examples:</div><div><u><font color=""#b06b0a"">17.423</font><font color=""#ba0a48"">.ceil</font>&nbsp; ==&nbsp;<font color=""#b06b0a"">18</font></u></div><div><u><font color=""#b06b0a"">17.423</font><font color=""#ba0a48"">.floor</font> == <font color=""#b06b0a"">17</font></u></div>"
"<div class=""tags"">Ruby</div><br>What syntax defines a proc?"	"<u><font color=""#aa00ff"">proc</font> { |param| block }</u>"
"<div class=""tags"">Ruby</div><br>Which method allows you to call a proc directly?"	<u>.call</u>
"<span class=""tags"">Ruby</span><br /><br /><br>Symbols don't <span class=cloze>[...]</span> values, they <span class=cloze>[...]</span> values."	"<span class=""tags"">Ruby</span><br /><br /><br>Symbols don't <span class=cloze>contain</span> values, they <span class=cloze>are</span> values.<br><br><br><div class=""extra""></div>"
"<span class=""tags"">Ruby</span><br /><br /><br>Symbols are primarily used as <span class=cloze>[...]</span> or for referencing&nbsp;method names."	"<span class=""tags"">Ruby</span><br /><br /><br>Symbols are primarily used as <span class=cloze>hash keys</span> or for referencing&nbsp;method names.<br><br><br><div class=""extra""><example><div><font color=""#ad3e3e"">sounds </font>= {</div><div>&nbsp; <font color=""#249e42"">:cat</font> =&gt; <font color=""#249e42"">""meow""</font>,</div><div>&nbsp; <font color=""#249e42"">:dog</font> =&gt; <font color=""#249e42"">""woof""</font>,</div><div>&nbsp; <font color=""#249e42"">:computer</font> =&gt; <font color=""#1eaa92"">10010110</font>,</div><div>}</div><div><font color=""#ad3e3e"">numbers_array</font>.<font color=""#507c96"">map</font>(&amp;<font color=""#249e42"">:to_s</font>)</div></example></div>"
"<span class=""tags"">Ruby</span><br /><br /><br>Symbols are primarily used as hash keys or for referencing&nbsp;<span class=cloze>[...]</span>."	"<span class=""tags"">Ruby</span><br /><br /><br>Symbols are primarily used as hash keys or for referencing&nbsp;<span class=cloze>method names</span>.<br><br><br><div class=""extra""><example><div><font color=""#ad3e3e"">sounds </font>= {</div><div>&nbsp; <font color=""#249e42"">:cat</font> =&gt; <font color=""#249e42"">""meow""</font>,</div><div>&nbsp; <font color=""#249e42"">:dog</font> =&gt; <font color=""#249e42"">""woof""</font>,</div><div>&nbsp; <font color=""#249e42"">:computer</font> =&gt; <font color=""#1eaa92"">10010110</font>,</div><div>}</div><div><font color=""#ad3e3e"">numbers_array</font>.<font color=""#507c96"">map</font>(&amp;<font color=""#249e42"">:to_s</font>)</div></example></div>"
"<div class=""tags"">Ruby</div><br>What syntax defines a lambda?"	"<u><font color=""#aa00ff"">lambda</font>&nbsp;{ |param| block }</u>"
"<div class=""tags"">Ruby</div><br>Which checks the number of arguments passed to it, a lambda or a proc?"	A lambda.
"<div class=""tags"">Ruby</div><br>What will a lambda do if you pass it the wrong number of arguments?"	Throw an error.
"<span class=""tags"">Ruby</span><br /><br /><br>A proc will <span class=cloze>[...]</span> unexpected arguments and assign <span class=cloze>[...]</span> to any that are missing."	"<span class=""tags"">Ruby</span><br /><br /><br>A proc will <span class=cloze>ignore</span> unexpected arguments and assign <span class=cloze>nil</span> to any that are missing.<br><br><br><div class=""extra""></div>"
"<span class=""tags"">Ruby</span><br /><br /><br>When a lambda returns, it <span class=cloze>[...]</span> back to the calling method."	"<span class=""tags"">Ruby</span><br /><br /><br>When a lambda returns, it <span class=cloze>passes control</span> back to the calling method.<br><br><br><div class=""extra""></div>"
"<div class=""tags"">Ruby</div><br>When a proc returns, does it go back to the calling method?"	No. (It does so immediately.)
"<div class=""tags"">Ruby</div><br>Ruby: Is a block an object on its own?"	No.<div>(But it can be saved as a proc or lambda)</div>
"<span class=""tags"">Ruby</span><br /><br /><br>Ruby: A block is just <span class=cloze>[...]</span> between <code>do...end</code> or <code>{ } </code>"	"<span class=""tags"">Ruby</span><br /><br /><br>Ruby: A block is just <span class=cloze>some code</span> between <code>do...end</code> or <code>{ } </code><br><br><br><div class=""extra""></div>"
"<span class=""tags"">Ruby</span><br /><br /><br>Ruby: A block is just some code between <code><span class=cloze>[...]</span></code> or <code><span class=cloze>[...]</span></code>"	"<span class=""tags"">Ruby</span><br /><br /><br>Ruby: A block is just some code between <code><span class=cloze>do...end</span></code> or <code><span class=cloze>{ } </span></code><br><br><br><div class=""extra""></div>"
"<span class=""tags"">Ruby</span><br /><br /><br>Ruby is an <span class=cloze>[...]</span>-oriented programming language."	"<span class=""tags"">Ruby</span><br /><br /><br>Ruby is an <span class=cloze>object</span>-oriented programming language.<br><br><br><div class=""extra""></div>"
"<br><span class=cloze>[...]</span> is a programming paradigm that represents the concept of <b><font color=""#5555ff"">objects</font></b> which have <font color=""#a20d28""><b>attributes</b></font> and associated procedures called <b><font color=""#0b792a"">methods</font></b>."	"<br><span class=cloze>OOP</span> is a programming paradigm that represents the concept of <b><font color=""#5555ff"">objects</font></b> which have <font color=""#a20d28""><b>attributes</b></font> and associated procedures called <b><font color=""#0b792a"">methods</font></b>.<br><br><br><div class=""extra"">OOP = Object-oriented programming</div>"
"<br>OOP is a programming paradigm that represents the concept of <b><font color=""#5555ff"">objects</font></b> which have <span class=cloze>[...]</span> and associated procedures called <span class=cloze>[...]</span>."	"<br>OOP is a programming paradigm that represents the concept of <b><font color=""#5555ff"">objects</font></b> which have <span class=cloze><font color=""#a20d28""><b>attributes</b></font></span> and associated procedures called <span class=cloze><b><font color=""#0b792a"">methods</font></b></span>.<br><br><br><div class=""extra"">OOP = Object-oriented programming</div>"
"<span class=""tags"">Programming</span><br /><br /><br>A <span class=cloze>[...]</span> is a way of producing objects with similar attributes and methods."	"<span class=""tags"">Programming</span><br /><br /><br>A <span class=cloze>class</span> is a way of producing objects with similar attributes and methods.<br><br><br><div class=""extra""></div>"
"<span class=""tags"">Programming</span><br /><br /><br>A class is a way of producing objects with <span class=cloze>[...]</span> attributes and methods."	"<span class=""tags"">Programming</span><br /><br /><br>A class is a way of producing objects with <span class=cloze>similar</span> attributes and methods.<br><br><br><div class=""extra""></div>"
"<span class=""tags"">Ruby</span><br /><br /><br>By convention, class names and module names start with a <span class=cloze>[...]</span> and use <span class=cloze>[...]</span>."	"<span class=""tags"">Ruby</span><br /><br /><br>By convention, class names and module names start with a <span class=cloze>capital letter</span> and use <span class=cloze>CamelCase</span>.<br><br><br><div class=""extra""></div>"
"<span class=""tags"">Ruby</span><br /><br /><br>In Ruby <span class=""code"">@</span> is put before a variable to signify that it's an <span class=cloze>[...]</span>."	"<span class=""tags"">Ruby</span><br /><br /><br>In Ruby <span class=""code"">@</span> is put before a variable to signify that it's an <span class=cloze>instance variable</span>.<br><br><br><div class=""extra""><example><lang class=""r"">Ruby</lang><font color=""#ad3e3e"">@iq</font> = <font color=""#1eaa92"">170</font> <font color=""#ec86a2"">#instance</font><div><code style=""text-align:center""><font color=""#ad3e3e"">@@species</font> = <font color=""#249e42"">:human</font> <font color=""#ec86a2"">#class</font></code></div><div><code style=""text-align:center""><font color=""#ad3e3e"">$reality</font> = <font color=""#249e42"">:merciless</font> <font color=""#ec86a2"">#global</font></code></div></example></div>"
"<span class=""tags"">Ruby</span><br /><br /><br>In Ruby <span class=cloze>[...]</span> is put before a variable to signify that it's an instance variable."	"<span class=""tags"">Ruby</span><br /><br /><br>In Ruby <span class=cloze><span class=""code"">@</span></span> is put before a variable to signify that it's an instance variable.<br><br><br><div class=""extra""><example><lang class=""r"">Ruby</lang><font color=""#ad3e3e"">@iq</font> = <font color=""#1eaa92"">170</font> <font color=""#ec86a2"">#instance</font><div><code style=""text-align:center""><font color=""#ad3e3e"">@@species</font> = <font color=""#249e42"">:human</font> <font color=""#ec86a2"">#class</font></code></div><div><code style=""text-align:center""><font color=""#ad3e3e"">$reality</font> = <font color=""#249e42"">:merciless</font> <font color=""#ec86a2"">#global</font></code></div></example></div>"
<br>What controls where a variable is visible and usable in a program?	Its scope.
"<span class=""tags"">Programming</span><br /><br /><br>Variables that are available everywhere are called <span class=cloze>[...]</span>."	"<span class=""tags"">Programming</span><br /><br /><br>Variables that are available everywhere are called <span class=cloze>global variables</span>.<br><br><br><div class=""extra""></div>"
<br>Variables that are only available to certain methods are called <span class=cloze>[...]</span>.	"<br>Variables that are only available to certain methods are called <span class=cloze>local variables</span>.<br><br><br><div class=""extra""></div>"
<br>Variables that are members of a certain class are called <span class=cloze>[...]</span>.	"<br>Variables that are members of a certain class are called <span class=cloze>class variables</span>.<br><br><br><div class=""extra""></div>"
<br>Variables that are only available to particular instances are called <span class=cloze>[...]</span>.	"<br>Variables that are only available to particular instances are called <span class=cloze>instance variables</span>.<br><br><br><div class=""extra""></div>"
"<div class=""tags"">Ruby</div><br>What are the respective prefixes for Instance, Class and Global variables?"	"<u><font color=""#ba0a48"">@</font></u>, <u><font color=""#ba0a48"">@@</font></u>&nbsp;and <u><font color=""#ba0a48"">$</font></u>"
"<div class=""tags"">Ruby</div><br>What is the scope of a variable declared outside of any method or class?"	Global
"<span class=""tags"">Programming</span><br /><br /><br>A specficic <i>and</i> <i>individual</i> object is known as an <span class=cloze>[...]</span>."	"<span class=""tags"">Programming</span><br /><br /><br>A specficic <i>and</i> <i>individual</i> object is known as an <span class=cloze>instance</span>.<br><br><br><div class=""extra""></div>"
<br>Object is to <span class=cloze>[...]</span> noun as Instance is to <span class=cloze>[...]</span> noun.	"<br>Object is to <span class=cloze>common</span> noun as Instance is to <span class=cloze>proper</span> noun.<br><br><br><div class=""extra""></div>"
"<div class=""tags"">Ruby</div><br>In Ruby, how many copies of a class variable are shared by its instances?"	One
<br>What is the process by which one class takes on the attributes and methods of another?	Inheritance
<br>Inheritance is used to express an <span class=cloze>[...]</span> relationship.	"<br>Inheritance is used to express an <span class=cloze>is-a</span> relationship.<br><br><br><div class=""extra"">Example: A <code>Fox</code> class could inherit from a <code>Mammal</code> class.</div>"
"<div class=""tags"">Ruby</div><br>What is the syntax for Ruby inheritance?"	"<u><font color=""#b06b0a"">DerivedClass</font> &lt; <font color=""#b06b0a"">BaseClass<br /></font></u>"
"<div class=""tags"">Ruby</div><br>In the following code, what is <u>&lt;</u>&nbsp;read as?<div><br /></div><example><div><u><font color=""#aa00ff"">class</font>&nbsp;<font color=""#b06b0a"">DerivedClass</font>&nbsp;&lt;&nbsp;<font color=""#b06b0a"">BaseClass</font></u><div><u>&nbsp; # Some stuff!</u></div><div><u><font color=""#aa00ff"">end</font></u></div></div></example>"	Inherits from
"<div class=""tags"">Programming</div><br>Can a derived class override the attributes and methods of its parent?"	Yes.
<br>A class' base class is also called a <span class=cloze>[...]</span> or <span class=cloze>[...]</span>.	"<br>A class' base class is also called a <span class=cloze>parent</span> or <span class=cloze>superclass</span>.<br><br><br><div class=""extra""></div>"
"<div class=""tags"">Ruby</div><br>What keyword allows you to directly access the attributes or methods of a superclass?"	<u>super</u>
"<div class=""tags"">Ruby</div><br>How many superclasses can any given class have?"	Only one. (This is called single inheritance)
<br>What is it called when a class can have more than one parent?	Multiple inheritance.
"<div class=""tags"">Ruby</div><br>What symbol ends a Ruby statement without going to a new line?"	<u>;</u>
"<div class=""tags"">Ruby</div><br>What type of method can be used by all instances of a class?"	A <b>class method</b>.
"<div class=""tags"">Ruby</div><br>Are methods private or public by default?"	Public
"<div class=""tags"">Ruby</div><br>Which keywords specify public and private methods?"	<u>public</u>&nbsp;and <u>private</u>
"<span class=""tags"">Ruby</span><br /><br /><br>Ruby interprets semicolons and newline characters as the <span class=cloze>[...]</span>."	"<span class=""tags"">Ruby</span><br /><br /><br>Ruby interprets semicolons and newline characters as the <span class=cloze>end of a statement</span>.<br><br><br><div class=""extra""></div>"
"<span class=""tags"">Ruby</span><br /><br /><br>Ruby interprets <span class=cloze>[...]</span> and <span class=cloze>[...]</span> characters as the end of a statement."	"<span class=""tags"">Ruby</span><br /><br /><br>Ruby interprets <span class=cloze>semicolons</span> and <span class=cloze>newline</span> characters as the end of a statement.<br><br><br><div class=""extra""></div>"
"<span class=""tags"">Ruby</span><br /><br /><br>An operator or backslash at the end of a line indicates the <span class=cloze>[...]</span> of a statement."	"<span class=""tags"">Ruby</span><br /><br /><br>An operator or backslash at the end of a line indicates the <span class=cloze>continuation</span> of a statement.<br><br><br><div class=""extra""></div>"
"<div class=""tags"">Ruby</div><br>In Ruby, what is a collection of methods and constants?"	A <b>module</b>.
"<div class=""tags"">Ruby</div><br>What is a module?"	A collection of <b>methods</b> and <b>constants.</b>
"<div class=""tags"">Ruby</div><br>What keyword are modules defined with?"	<u>module</u>
"<span class=""tags"">Ruby</span><br /><br /><br>By convention, <span class=cloze>[...]</span> names and <span class=cloze>[...]</span> names start with a capital letter and use CamelCase."	"<span class=""tags"">Ruby</span><br /><br /><br>By convention, <span class=cloze>class</span> names and <span class=cloze>module</span> names start with a capital letter and use CamelCase.<br><br><br><div class=""extra""></div>"
"<span class=""tags"">Ruby</span><br /><br /><br>One of the main purposes of modules is to separate methods and constants into <span class=cloze>[...]</span>."	"<span class=""tags"">Ruby</span><br /><br /><br>One of the main purposes of modules is to separate methods and constants into <span class=cloze>named spaces</span>.<br><br><br><div class=""extra"">This is called <b>namespacing</b>.</div>"
"<span class=""tags"">Ruby</span><br /><br /><br>One of the main purposes of modules is to separate <span class=cloze>[...]</span> and <span class=cloze>[...]</span> into named spaces."	"<span class=""tags"">Ruby</span><br /><br /><br>One of the main purposes of modules is to separate <span class=cloze>methods</span> and <span class=cloze>constants</span> into named spaces.<br><br><br><div class=""extra"">This is called <b>namespacing</b>.</div>"
"<div class=""tags"">PHP Ruby</div><br>Which operator specifies&nbsp;<i>where</i>&nbsp;you're looking for a specific bit of code?"	The <b>scope resolution operator</b>&nbsp;( <u>::</u>&nbsp;)<div><br /></div><div>Example: <u>Math::PI</u>&nbsp;returns the constant <u>PI</u>&nbsp;found within the <u>Math</u>&nbsp;module.</div>
"<div class=""tags"">Ruby</div><br>Which two statements are a limited form of multiple inheritance?"	<u>include</u>&nbsp;and <u>extend</u>
"<div class=""tags"">Ruby</div><br>Which keyword mixes a module's methods in at the&nbsp;<b>class</b>&nbsp;level?"	<u>extend</u>
"<div class=""tags"">Ruby</div><br>Which keyword mixes a module's methods in at the&nbsp;<b>instance</b>&nbsp;level?"	<u>include</u>
"<div class=""tags"">Ruby</div><br>What is a module called when used to mix additional behavior into a class?"	A mixin.
"<div class=""tags"">Ruby</div><br>Which keyword tells Ruby you want to bring in the contents of another file, such as a module?"	<u>require</u>
"<span class=""tags"">Ruby</span><br /><br /><br>When adding a module, <code>include</code> is to <span class=cloze>[...]</span> level as <code>extend</code> is to <span class=cloze>[...]</span> level."	"<span class=""tags"">Ruby</span><br /><br /><br>When adding a module, <code>include</code> is to <span class=cloze>instance</span> level as <code>extend</code> is to <span class=cloze>class</span> level.<br><br><br><div class=""extra""></div>"
"<span class=""tags"">Ruby</span><br /><br /><br>When adding a module, <span class=cloze>[...]</span> is to instance level as <span class=cloze>[...]</span> is to class level."	"<span class=""tags"">Ruby</span><br /><br /><br>When adding a module, <span class=cloze><code>include</code></span> is to instance level as <span class=cloze><code>extend</code></span> is to class level.<br><br><br><div class=""extra""></div>"
"<div class=""tags"">Ruby</div><br>What is allowed within integers to make it easier to read big numbers?"	Underscores. (&nbsp;<u>1000000 == 1_000_000</u>&nbsp;)
"<div class=""tags"">Ruby</div><br>What kind of parameter has a default value?"	An <b>optional parameter</b>.
"<div class=""tags"">Ruby</div><br>Which data type holds an ordered collection of values?"	An array.
"<div class=""tags"">Ruby</div><br>What kind of values can a Ruby array have?"	Any type of object.<div>( Hashes, Strings, Integers, other Arrays, etc. )</div>
"<div class=""tags"">PHP</div><br>What delimiters does PHP code go inside?"	<u>&lt;?php</u> and <u>?&gt;</u>
"<div class=""tags"">PHP</div><br>What file extension tells the PHP interpreter to evaluate it?"	<u>.php</u>
"<div class=""tags"">PHP</div><br>Which function outputs strings?"	<u>echo</u>
"<div class=""tags"">PHP</div><br>What does PHP require at the end of <i>every</i> statement?"	A semicolon.
"<div class=""tags"">Javascript PHP Ruby</div><br>What are the concatenation operators for Ruby, PHP and Javascript?"	"<u>&lt;&lt;&nbsp;</u>&nbsp;<u>.&nbsp;</u>&nbsp;and &nbsp;<u>+</u><div><u><br /></u></div><div>Ruby: <u><font color=""#005500"">""This will concatenate""</font> &lt;&lt; <font color=""#005500"">""with this""</font></u></div><div>PHP: <u><font color=""#005500"">""This will concatenate""</font> . <font color=""#005500"">""with this""</font></u></div><div>JS: <u><font color=""#005500"">""This will concatenate""</font> + <font color=""#005500"">""with this""</font></u></div>"
"<div class=""tags"">PHP</div><br>What do all variable names in PHP start with?"	<u>$</u>
"<span class=""tags"">Programming</span><br /><br /><br>Expression is to phrase as statement is to <span class=cloze>[...]</span>."	"<span class=""tags"">Programming</span><br /><br /><br>Expression is to phrase as statement is to <span class=cloze>sentence</span>.<br><br><br><div class=""extra""></div>"
"<span class=""tags"">Programming</span><br /><br /><br>Expression is to <span class=cloze>[...]</span> as statement is to sentence."	"<span class=""tags"">Programming</span><br /><br /><br>Expression is to <span class=cloze>phrase</span> as statement is to sentence.<br><br><br><div class=""extra""></div>"
"<span class=""tags"">Programming</span><br /><br /><br>Expression is to phrase as <span class=cloze>[...]</span> is to sentence."	"<span class=""tags"">Programming</span><br /><br /><br>Expression is to phrase as <span class=cloze>statement</span> is to sentence.<br><br><br><div class=""extra""></div>"
"<span class=""tags"">Programming</span><br /><br /><br><span class=cloze>[...]</span> is to phrase as statement is to sentence."	"<span class=""tags"">Programming</span><br /><br /><br><span class=cloze>Expression</span> is to phrase as statement is to sentence.<br><br><br><div class=""extra""></div>"
<br>What is a PHP comment preceded by?	<u>//</u>
"<div class=""tags"">PHP</div><br>Which statement checks multiple conditions?"	"A <u>switch</u>&nbsp;statement.<div><br /></div><example><lang class=""php"">PHP</lang><div><font color=""#507c96"">switch</font> <font color=""#507c96"">(</font><font color=""#ad3e3e"">$variableToCheck</font><font color=""#507c96"">)</font> {</div><div>&nbsp;<font color=""#507c96""> case</font> <font color=""#1eaa92"">1</font><font color=""#507c96"">:</font></div><div>&nbsp; &nbsp; <font color=""#507c96"">echo</font> <font color=""#249e42"">""1""</font><font color=""#507c96"">;</font></div><div>&nbsp; <font color=""#507c96"">case</font> <font color=""#1eaa92"">2</font><font color=""#507c96"">:</font></div><div>&nbsp; &nbsp; <font color=""#507c96"">echo</font> <font color=""#249e42"">""This will execute if 2 or 1,</font></div><div><font color=""#249e42"">&nbsp; &nbsp; because 1 has no break.""</font><font color=""#507c96"">;</font></div><div>&nbsp; &nbsp;<font color=""#507c96""> break;</font></div><div><font color=""#507c96"">&nbsp; default:</font></div><div><font color=""#507c96"">&nbsp; &nbsp; echo</font> <font color=""#249e42"">""If no other cases are met.""</font><font color=""#507c96"">;</font></div><div>}</div></example>"
<br>What is it called when you add multiple <u>case</u>s to a <u>switch</u>&nbsp;statement without a break?	Falling through.
<br>What is syntax called that is designed to make things easier to read or express?	Syntactic sugar.
"<div class=""tags"">PHP</div><br>Which PHP function declares an array?"	<u>array()</u>
"<div class=""tags"">PHP</div><br>When a parser complains about ""unexpected something"" at line <u>x</u>, which line do you look at first?<br />"	<u>x-1</u>
"<div class=""tags"">PHP</div><br>Which function destroys a variable or element of an array?"	"<u>unset()</u><br /><br /><example><font color=""#507c96"">&lt;?php</font><br /><font color=""#ec86a2"">//&nbsp;destroy&nbsp;a&nbsp;single&nbsp;variable</font><br /><font color=""#507c96"">unset(</font><font color=""#ad3e3e"">$foo</font><font color=""#507c96"">);</font><br /><br /><font color=""#ec86a2"">//&nbsp;destroy&nbsp;a&nbsp;single&nbsp;element&nbsp;of&nbsp;an&nbsp;array</font><br /><font color=""#507c96"">unset(</font><font color=""#ad3e3e"">$bar</font>[<font color=""#249e42"">'quux'</font>]<font color=""#507c96"">);</font><br /><br /><font color=""#ec86a2"">//&nbsp;destroy&nbsp;more&nbsp;than&nbsp;one&nbsp;variable</font><br /><font color=""#507c96"">unset(</font><font color=""#ad3e3e"">$foo1</font>,&nbsp;<font color=""#ad3e3e"">$foo2</font>,&nbsp;<font color=""#ad3e3e"">$foo3</font><font color=""#507c96"">);<br />?&gt;</font></example>"
"<div class=""tags"">Programming</div><br>What is the syntax of a <u>for</u>&nbsp;loop?"	<u>for (start; stop; interval)</u><div><u>statement</u></div>
<br><div>Which expression is executed once unconditionally at the beginning of the loop?</div><div><br /></div><u>for (expr1; expr2; expr3)</u><div><u>statement</u></div>	<u>expr1</u>
<br>Which expression is checked at the beginning of each iteration?<div><br /></div><div><u>for (expr1; expr2; expr3)</u><div><u>statement</u></div></div>	<u>expr2</u>
<br>Which expression is evaluated at the end of each iteration?<div><br /></div><div><u>for (expr1; expr2; expr3)</u><div><u>statement</u></div></div>	<u>expr3</u>
"<div class=""tags"">PHP</div><br>Which loop is used to iterate over each element of an object?"	"<u>foreach</u><example><div><font color=""#ad3e3e"">$arr</font>&nbsp;<font color=""#507c96"">=&nbsp;array(</font><font color=""#1eaa92"">1</font><font color=""#507c96"">,</font>&nbsp;<font color=""#1eaa92"">2</font><font color=""#507c96"">,</font>&nbsp;<font color=""#1eaa92"">3</font><font color=""#507c96"">,</font>&nbsp;<font color=""#1eaa92"">4</font><font color=""#507c96"">);</font></div><font color=""#507c96"">foreach&nbsp;(</font><font color=""#ad3e3e"">$arr</font>&nbsp;<font color=""#507c96"">as&nbsp;&amp;</font><font color=""#ad3e3e"">$value</font><font color=""#507c96"">)</font>&nbsp;{<br />&nbsp;&nbsp;&nbsp;&nbsp;<font color=""#ad3e3e"">$value</font>&nbsp;<font color=""#507c96"">=</font>&nbsp;<font color=""#ad3e3e"">$value</font>&nbsp;<font color=""#507c96"">*</font>&nbsp;<font color=""#1eaa92"">2</font><font color=""#507c96"">;</font><br />}</example>"
<br>Which PHP function returns the length of a string?	<u>strlen()</u>
"<div class=""tags"">PHP</div><br>Which two functions convert a string to uppercase or lowercase?"	<u>strtoupper()</u>&nbsp;and <u>strtolower()</u>
"<div class=""tags"">PHP</div><br>Which keyword declares a function?"	"<u>function</u><example><div><div><font color=""#507c96"">function</font> name<font color=""#507c96"">(</font><font color=""#ad3e3e"">$parameters</font><font color=""#507c96"">)</font> {</div><div>&nbsp; statement<font color=""#507c96"">;</font></div><div>}</div></div></example>"
"<div class=""tags"">PHP</div><br>Are PHP function names case sensitive or insensitive?"	Insensitive.<div><br /></div><div><u>strlen() </u>and<u> sTrLeN()</u>&nbsp;are interpreted the same.</div>
"<div class=""tags"">PHP</div><br>Which loop executes at least once?"	A <u>do...while</u>&nbsp;loop.
"<div class=""tags"">PHP</div><br>What must the constructor method be called?"	<u>__construct()</u>
"<div class=""tags"">Ruby</div><br>What is the name of the constructor method?"	<u>initialize</u>
"<div class=""tags"">PHP Ruby</div><br>Which keyword in PHP and Ruby calls the constructor after creating an object?"	"<u>new</u><div><u><br /></u></div><example><lang class=""php"">PHP</lang><u><font color=""#ba0a48"">$person</font> = <font color=""#aa00ff"">new</font> <font color=""#b06b0a"">Person</font>(<font color=""#00aa00"">""Joe""</font>,&nbsp;<font color=""#b06b0a"">23</font>);</u><div><u><br /></u></div></example><example><lang class=""r"">Ruby</lang><u><font color=""#ba0a48"">person</font> = <font color=""#b06b0a"">Person</font><font color=""#aa00ff"">.new</font> <font color=""#00aa00"">""Vale""</font>, <font color=""#b06b0a"">24</font></u></example>"
<br>A function bound to a class is called a <span class=cloze>[...]</span>.	"<br>A function bound to a class is called a <span class=cloze>method</span>.<br><br><br><div class=""extra""></div>"
"<span class=""tags"">Ruby</span><br /><br /><br>Since everything in Ruby is an object, every function is a <span class=cloze>[...]</span>."	"<span class=""tags"">Ruby</span><br /><br /><br>Since everything in Ruby is an object, every function is a <span class=cloze>method</span>.<br><br><br><div class=""extra""></div>"
"<div class=""tags"">PHP</div><br>Which pseudo-variable references the calling object?"	"<u><font color=""#ad3e3e"">$this</font></u>"
"<div class=""tags"">PHP</div><br>What is omitted when accessing a property from a class?"	"The&nbsp;<u><font color=""#ad3e3e"">$</font></u>&nbsp;prefix.<example><u><font color=""#507c96"">echo</font>&nbsp;<font color=""#ad3e3e"">$object</font> -&gt; <font color=""#ad3e3e"">some_variable</font></u></example>"
"<div class=""tags"">PHP</div><br>What keyword prevents a parent class method from being overridden?"	"<u>final</u><example><font color=""#507c96"">class</font> Example {<div>&nbsp; <font color=""#507c96"">final function</font> constant<font color=""#507c96"">()</font> {</div><div>&nbsp; &nbsp; <font color=""#507c96"">return</font> <font color=""#249e42"">""This method can't be overridden.""</font><font color=""#507c96"">;</font></div><div>&nbsp; }</div><div>}</div></example>"
"<div class=""tags"">PHP</div><br>Which keyword makes a class inherit from another?"	"<u>extends<br /></u><example><lang class=""php"">PHP</lang><u><font color=""#b06b0a"">DerivedClass</font> <font color=""#aa00ff"">extends</font> <font color=""#b06b0a"">BaseClass</font></u></example>"
"<div class=""tags"">PHP</div><br>Which keyword specifies a constant?"	<u>const<br /></u>
"<div class=""tags"">PHP</div><br>What do constants <i>not </i>start with?"	<u>$</u>
"<div class=""tags"">PHP</div><br>Which keyword allows you to use a class' property or method without creating an instance of that class?"	<u>static</u>
"<div class=""tags"">PHP</div><br>Which methods check if a property or method exists within a class?"	<u>property_exists() </u>and<u>&nbsp;method_exists()</u>
"<span class=""tags"">PHP Ruby</span><br /><br /><br>A Ruby hash is the equivalent of a PHP <span class=cloze>[...]</span>."	"<span class=""tags"">PHP Ruby</span><br /><br /><br>A Ruby hash is the equivalent of a PHP <span class=cloze>associative array</span>.<br><br><br><div class=""extra""></div>"
"<span class=""tags"">PHP Ruby</span><br /><br /><br>A Ruby <span class=cloze>[...]</span> is the equivalent of a PHP associative array."	"<span class=""tags"">PHP Ruby</span><br /><br /><br>A Ruby <span class=cloze>hash</span> is the equivalent of a PHP associative array.<br><br><br><div class=""extra""></div>"
<br>An associative array is also called a hash, a <span class=cloze>[...]</span>, a symbol table or a dictionary.	"<br>An associative array is also called a hash, a <span class=cloze>map</span>, a symbol table or a dictionary.<br><br><br><div class=""extra""></div>"
<br>An associative array is also called a hash, a map, a <span class=cloze>[...]</span> or a dictionary.	"<br>An associative array is also called a hash, a map, a <span class=cloze>symbol table</span> or a dictionary.<br><br><br><div class=""extra""></div>"
<br>An associative array is also called a hash, a map, a symbol table or a <span class=cloze>[...]</span>.	"<br>An associative array is also called a hash, a map, a symbol table or a <span class=cloze>dictionary</span>.<br><br><br><div class=""extra""></div>"
<br>Which data type is composed of a collection of <u>(key, value)</u> pairs, with each key appearing only once?	An <b>associative array</b>.
"<div class=""tags"">Ruby</div><br>Which data type is the equivalent of an associative array?"	A hash.
"<div class=""tags"">PHP</div><br>The PHP short array syntax replaces <u>array()</u>&nbsp;with..."	"<u>[ ]</u><example><font color=""#ad3e3e"">$short_syntax</font> <font color=""#507c96"">=</font>&nbsp;<font color=""#ad3e3e"">[</font><font color=""#249e42"">'this'</font><font color=""#507c96"">,</font><font color=""#249e42"">'is'</font><font color=""#507c96"">,</font><font color=""#249e42"">'also'</font><font color=""#507c96"">,</font><font color=""#249e42"">'an'</font><font color=""#507c96"">,</font><font color=""#249e42"">'array'</font><font color=""#ad3e3e"">]</font><font color=""#507c96"">;</font></example>"
<br>What does Ajax stand for?	Asyncronous javascript and XML.
"<div class=""tags"">PHP</div><br>What are these symbols called: &nbsp;<u>&lt;?php</u>&nbsp; &nbsp;<u>?&gt;</u>"	PHP tags.
"<span class=""tags"">PHP</span><br /><br /><br>You can place simple variables within <span class=cloze>[...]</span> strings."	"<span class=""tags"">PHP</span><br /><br /><br>You can place simple variables within <span class=cloze>double-quoted</span> strings.<br><br><br><div class=""extra""><example><lang class=""php"">PHP</lang><font color=""#7d95bc"">echo</font><font color=""#55aa00""> ""You ordered </font><font color=""#ba0a48"">$tireqty</font><font color=""#55aa00""> tires.""</font><font color=""#7d95bc"">;</font></example></div>"
"<span class=""tags"">PHP Ruby</span><br /><br /><br>Within single quotation marks, text is <span class=cloze>[...]</span>."	"<span class=""tags"">PHP Ruby</span><br /><br /><br>Within single quotation marks, text is <span class=cloze>unaltered</span>.<br><br><br><div class=""extra""></div>"
"<span class=""tags"">PHP Ruby</span><br /><br /><br>Within <span class=cloze>[...]</span> quotation marks, text is unaltered."	"<span class=""tags"">PHP Ruby</span><br /><br /><br>Within <span class=cloze>single</span> quotation marks, text is unaltered.<br><br><br><div class=""extra""></div>"
"<span class=""tags"">PHP Ruby</span><br /><br /><br><span class=cloze>[...]</span> quotes are known as soft quotes, and <span class=cloze>[...]</span> quotes are hard quotes."	"<span class=""tags"">PHP Ruby</span><br /><br /><br><span class=cloze>Double</span> quotes are known as soft quotes, and <span class=cloze>single</span> quotes are hard quotes.<br><br><br><div class=""extra""></div>"
"<span class=""tags"">PHP Ruby</span><br /><br /><br>Double quotes are known as <span class=cloze>[...]</span> quotes, and single quotes are <span class=cloze>[...]</span> quotes."	"<span class=""tags"">PHP Ruby</span><br /><br /><br>Double quotes are known as <span class=cloze>soft</span> quotes, and single quotes are <span class=cloze>hard</span> quotes.<br><br><br><div class=""extra""></div>"
"<div class=""tags"">PHP</div><br>What syntax defines strings using an end marker?"	"Heredoc syntax.<div><br /></div><example><span class=""identifier""><font color=""#ad3e3e"">$str</font>&nbsp;</span><span class=""statement""><font color=""#507c96"">=&nbsp;&lt;&lt;&lt; EOD</font><br /></span><span class=""string""><font color=""#249e42"">Here's an example of<br />a string defined using<br />Heredoc syntax.</font><br /></span><span class=""statement""><font color=""#507c96"">EOD;</font></span></example>"
"<div class=""tags"">PHP</div><br>What symbol is used for heredoc syntax?"	<u>&lt;&lt;&lt;</u>
<br>A variable's <span class=cloze>[...]</span> refers to the kind of data stored in it.	"<br>A variable's <span class=cloze>type</span> refers to the kind of data stored in it.<br><br><br><div class=""extra""></div>"
"<div class=""tags"">PHP</div><br>Which data type is used for whole numbers?"	Integer
"<div class=""tags"">PHP</div><br>Which data type is used for real numbers?"	Float
"<div class=""tags"">PHP</div><br>Which data type is used for strings of characters?"	String
<br>Which data type is used for <u>true</u>&nbsp;or <u>false</u>&nbsp;values?	Boolean
"<div class=""tags"">PHP</div><br>Which data type is used to store multiple data items?"	Array
"<div class=""tags"">PHP</div><br>Which data type is used for storing instances of classes?"	Object
"<span class=""tags"">PHP</span><br /><br /><br>PHP is a <span class=cloze>[...]</span> typed language."	"<span class=""tags"">PHP</span><br /><br /><br>PHP is a <span class=cloze>dynamically</span> typed language.<br><br><br><div class=""extra"">This means it determines data types automatically.<div><br /></div><div>Example:</div><code style=""text-align: left""><div><font color=""#ba0a48"">$numCups</font> = 6; <font color=""#aa00ff"">//numCups is an integer</font></div><div><font color=""#ba0a48"">$numCups</font> = <font color=""#55aa00"">""Six""</font>; <font color=""#aa00ff"">//numCups is now a string</font></div></code></div>"
"<span class=""tags"">PHP</span><br /><br /><br>You can pretend that a value is a different data type by using a <span class=cloze>[...]</span>."	"<span class=""tags"">PHP</span><br /><br /><br>You can pretend that a value is a different data type by using a <span class=cloze>type cast</span>.<br><br><br><div class=""extra""><example><lang class=""php"">PHP</lang><span style=""color: #0000BB"">&lt;?php<br />$foo&nbsp;</span><span style=""color: #007700"">=&nbsp;</span><span style=""color: #0000BB"">10</span><span style=""color: #007700"">;&nbsp;&nbsp;&nbsp;</span><span style=""color: #FF8000"">//&nbsp;$foo&nbsp;is&nbsp;an&nbsp;integer<br /></span><span style=""color: #0000BB"">$bar&nbsp;</span><span style=""color: #007700"">=&nbsp;(boolean)&nbsp;</span><span style=""color: #0000BB"">$foo</span><span style=""color: #007700"">;&nbsp;&nbsp;&nbsp;</span><span style=""color: #FF8000"">//&nbsp;$bar&nbsp;is&nbsp;a&nbsp;boolean<br /></span><span style=""color: #0000BB"">?&gt;</span></example></div>"
"<div class=""tags"">PHP</div><br>What enables you to change the name of a variable dynamically?"	"A variable variable.<example><font color=""#ad3e3e"">$World</font> <font color=""#507c96"">=</font> <font color=""#249e42"">""a""</font><font color=""#507c96"">;</font><div><font color=""#ad3e3e"">$Hello</font> <font color=""#507c96"">=</font> <font color=""#249e42"">""World""</font><font color=""#507c96"">;</font></div><div><font color=""#ad3e3e"">$a</font> <font color=""#507c96"">=</font> <font color=""#249e42"">""Hello""</font><font color=""#507c96"">;</font></div><div><br /></div><div><font color=""#ad3e3e"">$a</font><font color=""#507c96"">;</font> <font color=""#ec86a2"">//Returns Hello</font></div><div><font color=""#249e42"">$</font><font color=""#ad3e3e"">$a</font><font color=""#507c96"">;</font> <font color=""#ec86a2"">//Returns World</font></div><div><font color=""#249e42"">$$</font><font color=""#ad3e3e"">$a</font><font color=""#507c96"">;</font> <font color=""#ec86a2"">//Returns a</font></div></example>"
"<div class=""tags"">PHP</div><br>Which function provides a list of PHP's predefined variables and constants?"	<u>phpinfo()</u>
"<div class=""tags"">PHP</div><br>Booleans, integers, floats and strings are collectively known as what kind of value?"	Scalar
"<div class=""tags"">PHP</div><br>What is the scope of constants once declared?"	Global
"<div class=""tags"">PHP</div><br>Are global variables visible inside functions?"	No
"<div class=""tags"">PHP</div><br>A global variable declared inside a function refers to what?"	The <b>same</b> global variable <b>outside</b> the function.<br /><example><identifier>$a</identifier> <statement>=</statement> <constant>1</constant><statement>;</statement><br /><br><identifier>$b <statement>=</statement> <constant>2</constant><statement>;<br /><br>function</statement> sum<statement>()</statement> {<br /><br><statement>global</statement> </identifier><identifier>$a</identifier><statement>,</statement> <identifier>$b</identifier><statement>;<br /><br>echo</statement> <identifier>$a</identifier> <statement>+</statement> <identifier>$b</identifier><statement>;</statement><br>} <comment>//Output is 3</comment><br></example>
"<div class=""tags"">PHP</div><br>What is the scope of a variable created inside a function?"	Local
"<div class=""tags"">PHP</div><br>What happens to a local variable when its containing function terminates?"	It's destroyed.
"<div class=""tags"">PHP</div><br>What is the scope of a variable that can be seen inside and outside functions?"	Superglobal (Autoglobal)
<br>What are things being operated on called?	Operands
<br>Which increment operator assigns a value <i>then</i> returns it?	"The <b>pre-</b>increment operator<example><font color=""#507c96"">echo ++</font><font color=""#ad3e3e"">$a</font> <font color=""#ec86a2"">//Will print the value of $a + 1</font></example>"
<br>Which increment operator returns a value, <i>then</i>&nbsp;assigns it?	"The <b>post-</b>increment operator.<example><lang class=""php"">PHP</lang><div><font color=""#ad3e3e"">$a</font> <font color=""#507c96"">=</font> <font color=""#1eaa92"">10</font><font color=""#507c96"">;</font></div><div><font color=""#507c96"">echo </font><font color=""#ad3e3e"">$a</font><font color=""#507c96"">++;</font> <font color=""#ec86a2"">//Prints 10, <i>then</i>&nbsp;$a becomes 11</font></div></example>"
"<div class=""tags"">PHP</div><br>Which operator can make a variable point to the same location in memory as another?"	"The reference operator ( <u><font color=""#507c96"">&amp;</font></u> )<example><u><font color=""#ad3e3e"">$a</font> <font color=""#507c96"">=</font> <font color=""#1eaa92"">5</font><font color=""#507c96"">;</font></u><div><u><font color=""#ad3e3e"">$b</font> <font color=""#507c96"">= &amp;</font><font color=""#ad3e3e"">$a</font><font color=""#507c96"">;</font> <font color=""#ec86a2"">//Now $b points to the same place as $a</font></u></div><div><u><font color=""#ad3e3e"">$a</font> <font color=""#507c96"">=</font> <font color=""#1eaa92"">7</font><font color=""#507c96"">;</font> <font color=""#ec86a2"">//Also sets $b to 7</font></u></div></example>"
"<div class=""tags"">PHP</div><br>Which operator returns <u>true</u>&nbsp;only if the two operands are equal <i>and</i> of the same type?"	The identical operator ( <u>===</u>&nbsp;)
"<div class=""tags"">PHP</div><br>Which operators have higher precedence, <u>||</u> and <u>&amp;&amp;</u>&nbsp;or <u>or</u>&nbsp;and <u>and</u>?"	<u>||</u>&nbsp;and <u>&amp;&amp;</u>
<br>Which operator negates a boolean value?	<u>!</u>&nbsp;(Not)
<br>Which operator returns <u>true</u>&nbsp;if its operands have different truth values?	"<code>xor</code><example><div><font color=""#ad3e3e"">$a</font> <font color=""#507c96"">= </font><font color=""#1eaa92"">1</font><font color=""#507c96"">;</font></div><div><font color=""#ad3e3e"">$b</font> <font color=""#507c96"">=</font> <font color=""#1eaa92"">0</font><font color=""#507c96"">;</font></div><div><font color=""#ad3e3e"">$a</font> <font color=""#507c96"">xor</font> <font color=""#ad3e3e"">$b</font> <font color=""#ec86a2"">//returns true</font></div></example>"
"<div class=""tags"">PHP</div><br>Which operator separates functions and other list items?"	<u>,</u>&nbsp;
"<div class=""tags"">PHP</div><br>Which operator can be used in front of any expression to suppress errors?"	<u>@</u>&nbsp;(Error suppression operator)
"<div class=""tags"">PHP</div><br>Which operator tells PHP to execute its operand in the command line?"	The execution operator ( <u>` `</u> )
"<div class=""tags"">PHP</div><br>Which operator checks whether an object is an instance of a particular class?"	"<u>instanceof</u><example><lang class=""php"">PHP</lang><font color=""#507c96"">if (</font><font color=""#ad3e3e"">$myObject</font> <font color=""#507c96"">instanceof</font> sampleClass<font color=""#507c96"">)</font></example>"
"<div class=""tags"">PHP</div><br>What pseudo-type represents many data types?"	Mixed
"<div class=""tags"">PHP</div><br>Which function checks if a variable has a value?"	"<u>isset<font color=""#507c96"">()</font></u>"
"<div class=""tags"">PHP</div><br>Which functions cast a variable as integer, float and string respectively?"	<u>intval(), floatval()</u>&nbsp;and <u>strval()</u>
<br>What are the constructs that allow your program to make decisions?	Conditionals.
"<div class=""tags"">PHP</div><br>What must conditions in <u>if</u>&nbsp;statements be surrounded by?"	Parentheses.
<br>What are the <u>==</u>&nbsp;and <u>=</u>&nbsp;operators called?	Equals and Assignment.
"<span class=""tags"">Ruby</span><br /><br /><br>Declare a block by enclosing it in <span class=cloze>[...]</span>."	"<span class=""tags"">Ruby</span><br /><br /><br>Declare a block by enclosing it in <span class=cloze>braces</span>.<br><br><br><div class=""extra""></div>"
"<div class=""tags"">PHP</div><br>How many blocks in a cascade of <u>elseif</u>&nbsp;statements will be executed?"	One. (The first true one.)
"<div class=""tags"">PHP</div><br>A <u>switch</u>&nbsp;statement would execute all the code following a true <u>case</u>&nbsp;without which keyword?"	<u>break</u>
<br>Which statement stops execution of a loop?	<u>break</u>
"<div class=""tags"">PHP</div><br>Which statement jumps to the next loop iteration?"	<u>continue</u>
"<div class=""tags"">PHP</div><br>Which statement exits the entire PHP script?"	<u>exit</u>
"<div class=""tags"">PHP</div><br>What built-in variable gives the directory the script is in?"	"<u><font color=""#ad3e3e"">$_SERVER[</font><font color=""#249e42"">'DOCUMENT_ROOT'</font><font color=""#ad3e3e"">]</font></u>"
"<div class=""tags"">PHP</div><br>Which function opens a file?"	<u>fopen()</u>
<br>How many steps does reading/writing to a file take?	Three. (Open, Read/Write, Close)
"<div class=""tags"">PHP</div><br>Which simple PHP function writes to a file?"	"<u>fwrite()</u><div><u><br /></u><div><u><span class=""type"">int</span> <span class=""methodname""><strong>fwrite</strong></span><br>    ( <span class=""methodparam""><span class=""type"">resource</span> <code class=""parameter"">$handle</code></span><br>   , <span class=""methodparam""><span class=""type"">string</span> <code class=""parameter"">$string</code></span><br>   [, <span class=""methodparam""><span class=""type"">int</span> <code class=""parameter"">$length</code></span><br>  ] )</u></div></div>"
"<div class=""tags"">PHP</div><br>Which two functions allow you to read/write a file without <u>fopen()</u>&nbsp;and <u>fclose()</u>?"	<u>file_get_contents()</u>&nbsp;and <u>file_put_contents()</u>
"<div class=""tags"">PHP</div><br>Which function returns <u>true</u>&nbsp;when the&nbsp;end of a file is reached?"	<u>feof()</u>
"<div class=""tags"">PHP</div><br>Which function reads&nbsp;from a file&nbsp;one line at a time?"	<u>fgets()</u>
"<div class=""tags"">PHP</div><br>What PHP function is similar to <u>fgets()</u>&nbsp;except that it strips any PHP or HTML tags?"	<u>fgetss()</u>
"<div class=""tags"">PHP</div><br>Which function resets the file pointer to the beginning?"	<u>rewind()</u>
"<div class=""tags"">PHP</div><br>Which function reports how far a file pointer is into the file in bytes?"	<u>ftell()</u>
"<div class=""tags"">PHP</div><br>Which function sets the file pointer's position in a file?"	<u>fseek()</u>
"<div class=""tags"">PHP</div><br>What function should be called after a file is opened but before any data is written?"	<u>flock()</u>
<br>What type of variable holds a single value?	A <b>scalar</b>&nbsp;variable.
"<div class=""tags"">PHP</div><br>Which sort function requires a user-defined comparison function?"	<u>usort()</u>
"<div class=""tags"">PHP</div><br>Which function tells you how many elements are in an array?"	<u>count()</u>
"<div class=""tags"">PHP</div><br>Which function removes any excess whitespace?"	<u>trim()</u>
"<div class=""tags"">PHP</div><br>What is the <u>%</u>&nbsp;character in a format string called?"	A conversion specification.
"<div class=""tags"">PHP</div><br>Which function prints a format string?"	<u>printf()</u>
"<div class=""tags"">PHP</div><br>What symbol do all conversion specifications start with?"	<u>%</u>
"<div class=""tags"">PHP</div><br>Which function takes an input string and replaces all of its<div>newlines with <u>&lt;br /&gt;?</u></div>"	<u>nl2br()</u>
"<div class=""tags"">PHP</div><br>Which function sends email?"	<u>mail($to,$subject,$message)</u>
"<div class=""tags"">PHP</div><br>What is the difference between <u>printf()</u>&nbsp;and <u>sprintf()</u>?"	One prints and the other returns a string.
<br>A <span class=cloze>[...]</span> describes the basic shape of output using format codes instead of variables.	"<br>A <span class=cloze>format string</span> describes the basic shape of output using format codes instead of variables.<br><br><br><div class=""extra""></div>"
"<div class=""tags"">PHP</div><br>In a format string, what does <u>%3$</u>&nbsp;mean?"	Replace with the 3rd argument.
"<div class=""tags"">PHP</div><br>Before you add any strings to a database what do you need to do?"	"Escape potential control characters ( <u>\ ' "" NULL</u> )"
"<div class=""tags"">PHP</div><br>Which two functions separate a string or join an array using a delimiter?"	<u>explode()</u>&nbsp;and <u>join()</u>
"<div class=""tags"">Programming</div><br>What describes a pattern in a piece of text?"	A regular expression.
<br>What does PCRE stand for?	Perl Compatible Regular Expression
"<div class=""tags"">PHP</div><br>Which two configuration options automatically add a header and footer to each page in a directory?"	<u>auto_prepend_file</u>&nbsp;and <u>auto_append_file</u>
<br>What is a self-contained module of code that prescribes a calling interface, performs some task and optionally returns a result?	A function.
<br>What type of function calls <i>itself</i>?	A recursive function.
"<div class=""tags"">Programming</div><br>What is an abstract container that holds a group of identifiers?"	A namespace.
"<div class=""tags"">PHP</div><br>What keyword defines a class?"	<u>class</u>
"<div class=""tags"">PHP</div><br>What three access modifiers does PHP support?"	<u>public</u>,&nbsp;<u>private</u>&nbsp;and <u>protected</u>
"<div class=""tags"">PHP</div><br>What is the default access modifier?"	<u>public</u>
<br>What verb means to create a new object of a class?	Instantiate.
